荣耀任务	　　荣耀任务app是全新上线的一款兼职做任务赚收益平台，玩家通过荣耀任务平台接收任务，完成即可获得高额佣金，你只需动动手指，按要求完成系统派发的工单任务就可以轻轻松松的赚钱，新手用户也可以很快的上手，不用过多的担心，荣耀任务这里所有的任务单价佣金都是各不相同的，根据难度、完成的时间决定。
极速短视频	　　极速短视频app是一款更为好用的短视频分享兼职平台，极速短视频app能提供更为精彩的短视频内容去分享查看，直接分享到多个不同的社交圈中即可，每一次的分享都是有奖励的，所以会给大家带来更为独特的兼职新方式，全新的短视频都能在这里浏览，比较的方便！
嘉实财富	　　嘉实财富app为客户打造的全球精选优质公司及产品、并配备卓越理财顾问的财富管理服务平台。嘉实财富app将成为中国能够真正代表投资人利益的平台，嘉实财富app秉承“远见者稳进”的理念，依托强大的集团背景，以全球化视野，为客户提供全方位的财富管理服务。
米赚	　　中国第一手机赚钱平台。米赚在2011年9月正式发布，是国内第一个专注于移动威客的手机应用，拥有500万用户，是国内最大的手机赚钱应用。
裕民银行	　　江西裕民银行app全新上线，新服务、新体验，为你而来。
多多悬赏	　　多多悬赏是一款集互助砍价和走路赚钱和自由发布任务的平台，可以帮别人砍价赚取金币，也可以自己发布砍价任务，让大家帮你极速砍成，走路赚钱，用户在多多互助这款软件可以轻松赚钱，每天只需走路就能轻松赚取收益，每天签到还有金币奖励，金币可以用来兑换奖励！
这厮有礼	　　这厮有礼是一款在线调研类APP，用户可以参与在线调查并获得奖励。用户接取任务完成任务既可以获取奖励，单价高，提现迅速
天星金融	　　小米天星金融app由小米官方推出的手机在线金融服务平台，天星金融主要是为各位用户提供理财、保险、借贷等等方面的服务。在这里，可以帮你解决关于“钱”的问题。天星金融旨在为米粉和用户提供安全、快捷、方便的金融科技服务，并致力于成为全球米粉和新制造业的全面金融伙伴。
莱月再生	　　莱月再生app是一个为再生资源行业提供金融监管解决方案的平台。构建多维度的再生资源行业生态，为生态中的所有成员提供在线支付、电子合同签约、供应链金融等服务。
惠支付商户版	　　惠支付商户版是四川农信为特约商户量身打造的一款通用的支付收单工具。
欢乐赚赚赚	　　欢乐赚赚赚app欢乐赚赚赚app是一款休闲赚钱软件，走路赚钱、运动赚钱、阅读赚钱等多种赚钱活动在这里都可以找到，帮助用户进行赚钱打造.走路赚钱、运动赚钱、刮卡赚钱、种水果赚钱、看文章赚钱、早起赚钱、购物赚钱，玩手机就能轻松赚零钱！欢乐赚一款专门为用户打造的网赚APP，你的第二份工资就在欢乐赚！
睿投科技	　　睿投科技app是针对短视频设计的辅助软件，睿投科技软件的功能十分强大，可以给用户批量进行视频点赞，让用户能够快速获得点赞数量的任务，有了睿投科技app用户会释放双手，自动为短视频点赞。各大主播平台发布作品以及对用户的抢夺需要点击率、点赞率！而睿投科技这一自主研发的手自一体、及时切换IP点赞机器人应运而生，睿投科技平台合作对象包括短视频、快手、火山、西瓜视频、微视等短视频自媒体平台。睿投科技app为以上合作对象提供网红推广视频自动点赞平台，发布任务，睿投科技软件招募点赞能手，从中赚取佣金差价。
字节传媒	　　字节传媒app里面的点赞任务很多，而且会不断的更新，大家不用担心没有任务做。主要是抖音作品点赞、关注和分享，每天利用自己空闲的时间就能够赚到点收益，还是很不错的，至少零花钱还是可以保证的。所有的用户都需要账号登录进来，新用户直接手机号注册，然后绑定自己的账户，方便之后进行提现。
多尚记账	软件介绍
今融道	今融道APP是一款以北京金融街、上海陆家嘴、深圳福田中心、香港中环为核心发起的金融连接平台，今融道APP秉承共享金融，分享价值的用户理念，精准匹配金融问答、金融资讯、项目平台、金融招聘、圈层社交、数据研究等多维度的金融信息服务。
ZCBX众创链	众创链ZCBX正在空投，矿池排队模式，注册并通过认证，获得500矿池，，团补，星级达人式制度，团队化推广！
海洋公链	海洋公链NOC正在空投，注册并通过认证，获得矿机一台，邀请补，团补，星级达人式制度，团队化推广!
恒生个人理财	　　私人银行
朝阳智投	　　朝阳智投APP(66966.cn)，专注线上投顾服务，智能工具+人工服务，解决一亿股民炒股需求。
蜻蜓点金	　　蜻蜓点金app原名“中信建投证券APP”，蜻蜓点金app是中信建投证券官方为广大投资者倾力打造的炒股/投资/理财/基金/证券/财经资讯/金融软件，致力于为广大交易者提供极速、安全、优质、全面的股票、投资、理财平台。极速交易行情、丰富理财产品、独家精彩资讯、线上业务办理、金牌投顾互动、智能选股家族、大数据分析、云端同步自选股，尽在蜻蜓点金APP！
恒大交易	　　恒大交易一款专业的金属现货产业平台。由恒大金属交易中心股份有限公司推出。恒大交易app为用户带来最新的贵金属现货投资咨询、行情报道等信息，帮助用户掌握一手资源，软件由省政府正规批文，安全可靠。
珠江直销银行	
小米分期	　　小米贷款app是小米官方全新上线的贷款应用手机客户端，小米贷款app为用户提供纯信用贷款服务，这款小米贷款app获贷简单，仅需“认证-申请-放贷”3步搞定。整个过程不到2分钟，规范透明。小米贷款app按天计算利息也很灵活，用起来没压力。
易赚墙	　　易赚墙是什么？
以太猴	　　以太猴app主打挖矿赚钱，用户注册就有矿机领取，业余时间随时来赚钱~靠谱矿机项目，让对区块链感兴趣的朋友们可以放心来赚零花钱，无需任何投资，每天都有稳定收益等着你~来这里领养以太猴，参与宠物互动、交易等都能获取利益~更有推广项目上线，小伙伴们可以加入团队，不断发展下线，分红奖励拿到手软。
世基黄蓝带	　　世基黄蓝带app打造平民智能量化策略交易平台，黄蓝带手机版让普通投资者也能随时随地、快速轻松地学习、使用炒股策略，并且云端托管后可时时盯盘，把握最佳买卖时机，世基黄蓝带标准版让你一边省时省力省流量，一边赚钱。
先锋期货开户	先锋期货开户app致力于为客户提供专业的风险管理和财富管理服务，为新入市的投资者提供线上便捷开户和期货交易服务。投资者可使用先锋期货开户App办理期货网上开户业务。客户只需持有身份证、银行卡、带有视频功能的手机就可随时随地极速开户，无资金门槛投资期货，专业让投资更简单！
云账本	软件介绍
嘉善农商银行	功能介绍
泰达云	　　泰达云app是一款区块链软件，泰达云app是一款usdt场外亲自搬砖的应用，泰达云app里只要完成实名认证就可以启动交易，可以随时抢单买和寄售，非常方便，泰达云app就是一个赚差价的平台，自己想办法在各种货币之间进行转换，只要你可以研究出来，你就可以有无限的财富可以随时轻松的赚取，可以随时在线获取更多的收益，可以随时按照这里的规则来一步步的玩，邀请更多的用户加入这里，可以获取更多的佣金！
68赚网	　　68赚网手机版，只需每天浏览广告、点击广告、悬赏任务，都可以轻松获得金币，兑换成现金，大家速度来做，赚零花钱，赚生活费，我每天花1小时做任务。
融托金融	　　1.移动理财、更省心！
68接单	　　68接单软件平台上所有上新的任务都经过人工检查，可以保证所有信息都是真实可靠
方喜元	　　方喜元app每天都有很多商家来发布任务，用户就根据任务来完成
金挚	　　金挚APP是金智东博（北京）教育科技有限公司引入权威银行专家团队和顶尖互联网团队，历时两年的调研和开发，针对金智用户的营销需求专属定制的营销策略神器。
基金E站	　　1、每日净值：公司基金产品每日净值、涨跌幅、历史净值走势等信息的快速查询;
友金所	　　【认识友金所】 友金所由用友网络（股票代码：600588）、深圳力合金控与银行专家管理团队联合设立。作为用友集团成员企业，友金所致力于提供专业的全流程金融信息服务，打造安全、便捷、可信的综合性投融资平台，为投资客户提供安全、本息担保、收益稳健的互联网理财服务。 友金所作为专业的互联网金融P2P理财平台，收益高达15%，更有YY理财、友金e富等期限灵活理财产品，总有一款适合您。
深农商企业版	　　深圳农村商业银行专为您打造的企业手机银行客户端，为您的企业带来轻松便捷的移动金融体验。简单，更懂你!
牛牛赚	　　牛牛赚app是一款最新上线的微信挂机赚钱APP，效率惊人享有非常可观挂机收益。
微享任务	　　微享任务app是最新的做任务赚钱软件，
温州银行	　　温州银行手机银行客户端（安卓版）是根据Android系统特点而开发的移动金融服务系统，利用手机为载体，通过手机上网登录客户端操作，作为一种崭新的电子银行服务渠道，更加突出了“随时随地、贴身快捷、方便时尚”的独特性，真正实现了“Whenever、Wherever（任何时间、任何地点）”的新型电子银行服务理念。
上海银行	上海银行全新推出个人手机银行，汇聚众多新颖实用功能，无论您使用任何品牌通信运营商网络或WIFI网络都可轻松使用。
东莞银行	　　在具备转账汇款、缴费支付、投资理财、账户管理、手机充值、网点地图、自助预约等常用功能的同时，还为广大客户提供手机商城、证券服务、存贷款计算器、机票酒店预订等便捷生活服务。
记米宝	　　亲们是不是还在苦苦寻找一款小巧简洁好用的个人薪资记账APP?现在,她来了。
爱心帮扶	爱心帮扶LOV正在空投，注册并通过实名认证，获得矿机一台，邀请补，社群补，等级制度达人团队化推广!
卡牛信用卡管家	　　【多重保障】　　大品牌打造，用户数据安全有保障；　　支持狠到位，随手网服务有口皆碑；　　数据非实名，用户与数据无任何关联；
光大金阳光	　　金阳光移动证券是光大证券为客户鼎力打造的全新一代移动证券平台，为客户提供专业的证券行情、交易、资讯服务。金阳光移动证券采用多项业内领先技术，使行情更快捷、交易更安全、资讯更及时，为客户提供全方位的专业证券服务。
WenX交易所	WenX交易所是一款非常不错的金融理财类手机软件，WenX交易所官方版有着大量的区块链信息，WenX交易所官方app可以让你在线快速的进行数字货币交易哦！
邮储银行	　　本产品是中国邮政储蓄银行为Andriod用户量身打造的新一代手机银行,系统按照“以客户为中心”的理念设计和构建,让您在使用手机银行系统时感到简单、方便、安全、快捷、时尚。　　中国邮政储蓄银行手机银行致力于建成一个符合中国邮政储蓄银行应对全方位、立体化金融服务的需要,涵盖基于移动互联网渠道的个人金融服务品种,为客户提供多功能、现代化、简易、便捷、安全的移动金融服务窗口,实现符合中国邮政储蓄银行渠道发展需要,满足客户对于移动金融产品灵活创新要求的电子交易平台。　　手机客户端操作简单实用,安全高效,欢迎安装使用,享受手机银行的全新体验。
云闪钻	云闪钻是一个双肾矿机模式应用，拒绝ZJ盘，自带造血功能，现在云闪钻首码免费排线正在进行中，有兴趣的速度参与！
华赢海马	　　华赢海马app是一家互联网金融公司。我们始终相信，华赢海马app的客户值得拥有更便捷更可靠的投资理财方式，华赢海马app利用先进的互联网技术为投资者提供更快捷的券商服务。在为投资者保驾护航的同时，华赢证券努力打造成为一个“经营规范。结构完善、管理科学、风控严格”的金融投资平台
记账有钱	今日你花了多少钱？记账有钱app是一款轻便，简洁的记账好帮手！适用于旅行记账，生意记账，学生记账，学生账本，亲子账本，装修记账，人情记账，日常记账，家庭账本，随手记账等。用简洁的方式，记录每一笔消费。
快记账	　　史上最适合年轻人的记账app!功能全面内存小，界面清新启动快，为你省钱省力省时间！提供快速方便的一键记账功能，清晰明了的消费支出报表，更包含记账闹钟、购物清单、云端同步等实用功能，陪伴每一个认真对待生活的你！
金魔仆	　　1、优选基金，智能决策(金智帮您搜集全面的行业大数据)
来客坊	　　来客坊app是一款专业的房产服务平台。来客坊app之前主要是从事酒店民宿运营，现在转型做区块链啦，新用户注册下载来客坊app就送一个新手任务包，每天签到就能领取来客券，来客坊app既可以用于订房，又可以交易变现，感兴趣就下载来客坊app体验一下项目玩法吧。
Tiger Trade	　　DDD为什么选择 Tiger TradeDDD
广发易淘金	　　广发证券易淘金从华泰证券、海通证券、中信证券、平安证券、国泰君安等券商中脱颖而出，荣获“新浪财经2015年券商APP风云榜”第一名，总下载使用次数超过5000万次。
周薪薪	　　1、每周发工资：每周可预支上周工资，生活有保障，每周有钱花
优配策略	　　在优配策略app，不管你想学习股票入门知识，还是炒股技巧、炒股绝招，炒股票高手就用优配策略！
联泰基金	　　联泰基金app是一款非常受欢迎的基金理财软件，联泰基金app提供基金开户，基金交易，账户查询等功能。还有每日资产明细，联泰基金app让你清楚了解每一笔收益，资产状况一目了然。联泰基金app致力向投资者提供权威、专业、及时、全面的理财服务，涵盖基金交易、金融资讯、理财行业动态、基金数据、基金评级、投资理财分析等内容。
东兴198	　　东兴198开启3.0智能炒股时代，快闪电下单、一键打新、先人一步 美 
优雅的UI设计、界面美观、大方体验流畅、开启移动互联网+券商创新新生代交互体验全开户、行情、交易、资讯、融资融券、理财、业务办理、金股在线(投顾产品)、实盘金股(投顾产品)、添迎利、兴e融、客服1对1智凝聚智能大数据技术的各种新功能，让你在股市如虎添翼 
数据决定价值，科技发现机会。
e百福商家	功能介绍
重庆农村商业银行	　　重庆农村商业银行app是重庆农村商业银行从传统银行到移动银行一次重大的飞跃与进步，重庆农商行客户端的成立标志着广大重庆农村商业银行的用户无需去银行排队就能在手机上实现查询账户、转账汇款等一系列服务，同时也提高了用户对于重庆农村商业银行的满意度。
中泰融易理财	　　中泰融易理财是中泰证券重点推出的集理财、服务、行情、业务办理功能于一体的新一代互联网金融APP，在实现查看股票行情、资讯的基础之上，我们隆重推出了7*24小时理财账户体系，您随时可以轻松开启您的快乐理财之旅，让您的资金在股市休市后也不“睡觉”，持续助您成就财富梦想。
西安银行企业手机银行	功能介绍
蛋卷基金理财	　　蛋卷基金 - 简单买基金，雪球出品 
蛋卷基金是「雪球」公司出品的基金APP。雪球聚集中国最多最聪明的股民投资者;蛋卷精选优质基金，让您「简单买基金」。
天安金交所	　　天安金交所 ，全称“天安(贵州省)互联网金融资产交易中心股份有限公司”， 
2015年11月在贵州注册成立，由贵州省人民政府金融工作办公室备案审批成立，注册资金1亿元，100元起投，预期年化收益5.8~7.3%，本金及预期收益由天安财险提供履约保证保险。在国际金融中心上海陆家嘴和互联网大数据产业中心贵阳设立双总部。
天洛爱分享	　　天洛爱分享软件是一款全新上线的分享文章、视频就能轻松赚钱的app平台。这款天洛爱分享app拥有比较完善的奖励体系，所有天洛爱分享的任务都能在完成之后分分钟获取收益，提现0门槛，是大家都非常喜欢的线上学习平台，天洛爱分享软件并不需要任何的基础就能快速完成，每个任务的单价也比较高，每天赚到的钱都能轻松提现！
招商基金	　　资金流动管理再提速 招商基金APP快速赎回升至1000万:近日，招商基金在保障平台交易安全、便捷的基础上，对旗下理财客户端招商基金APP再度升级提速，其T+0取现额度从单笔单日500万提升至1000万。同时，对接银行渠道的直连快捷支付也已经扩容到8家，其中单笔单日支付额度达到百万级以上的渠道有7家。
美伽汇	v2.11.01.新增融易购功能2.一些已知问题的修复。
中邮通达信	　　中邮证券有限责任公司，2002年9月经中国证券监督管理委员会批准设立，注册资本20.6亿元人民币。中邮证券是中国邮政集团公司绝对控股的证券类金融子公司。
爽爽bank	　　爽爽bank是贵阳银行专门为智能手机和移动终端客户打造的移动金融服务平台，爽爽bank为您提供超级转账、余额查询、个人账户管理、交易记录查询等诸多金融服务，满足您的移动金融需求。爽爽bank界面方便简洁、可自定义自己喜爱的功能服务。爽爽bank高度集成了直销银行功能，直销银行用户专为非贵阳客户量身打造，方便客户进行理财交易。
宜信星火金服	　　星火金服app，一款会赚钱APP，给你稳稳的幸福！
海峡银行	　　（一）易用便捷
快摇吧	　　摇红包神器
e赚	　　良好的用户体验凭其特点快速聚拢用户
华融e银	　　（1）无地域限制：电子账户轻松开，跨行绑卡随地用
钱鹿	　　＂钱鹿＂，是一个崭新的移动APP的实用平台，
uu集步宝	　　uu集步宝app是一款超级火爆的走路赚钱软件，uu集步宝app只需要通过走路就能获取收益，并且uu集步宝app可以自动运行，不需要做任何东西，你每走的一部都能产生价值，每天签到还能获得红包奖励，让你的步数兑换金币，金币兑现！
旅途人生	　　旅途人生红包版是一个视频+区块链的模式，不是传统的合成模式哦，旅途人生红包版通过看视频的方式来增加年龄，年龄又可以生产成长值积分，积分可以买卖、赠送，也可以兑换分红，玩法新颖有趣，喜欢就下载旅途人生app体验吧。
GK大漠科技	　　GK大漠科技app是一个简单的矿机模式区块链挖矿赢奖励的软件。注册就送一台矿机，通过实名认证再送一台，大漠科技app可以快速的获益，GK大漠科技拥有海量任务轻松赚金币，包含了多种类型的任务模式，GK大漠科技app结合区块链，让不用兴趣的用户都可以在这里进行赚金币任务操作，体验游戏赚金币方式，让收益更轻松。
奇乐短视频	　　奇乐短视频app是最近大家都在玩的一款短视频社交软件，在奇乐短视频app这里可以观看非常多的精彩短视频内容，奇乐短视频app可以边看视频边赚金币，收益很不错，边玩还能边赚，自己也能发布短视频内容，有多重的收益方式，奇乐短视频给大家带来简单轻松的赚金币项目，随时操作，打开手机看视频，喜欢的朋友欢迎来下载哦。
花花赚钱	　　花花赚钱app是最近上线的兼职平台，各种类型的都有提供，小伙伴们可以积极的使用，花花赚钱app利用自己空闲的时间来完成，是每一个爱好兼职的用户们都想要的软件。所有的资源和服务都是免费呈现的，佣金收入的也都不错，还可以绑定自己的账户直接体现。
赚钱用	功能介绍
比特界	　　比特界app是一款比较典型的币圈资讯平台，比特界app同时融入了区块链赚钱项目，每天流量新闻，做做任务就等于是在挖矿了，比特界还有完善的推广制度和交易制度，人人都可以参与，比特界APP，据传比特矿工联盟发起的，具有推广和扩散收益！
趣世界	　　趣世界app是刚出的星事物模式持币分红赚钱的平台。趣世界app拥有多种赚钱的模式，用户可以随意在线进行选择自己喜欢的赚钱模式，都是非常简单的，很快就可以完成，同时用户只需要在空闲的时候完成趣世界app的任务就可以了，还可以邀请自己的好友加入趣世界平台，也是有一定的收益可以获取的，每天的收益都是很可观的。
EB趣智慧	　　EB趣智慧app是一款和网赚资源相结合的区块链赚钱软件。大家能快速的实名认证，能参与EB趣智慧app星际达人的认证，EB趣智慧还能兑换矿机，能玩转种树的游戏，得到趣果的收益，趣智慧非常的多元化，任务超多，收入可观就在趣果世界app！
通联钱包	　　通联钱包app是通联支付旗下的移动支付产品，
奇点交易所	　　奇点交易所app是一款很安全的数字货币交易平台。这个奇点交易所平台上有多种数字货币，里面给大家带来了最新的数字货币资讯，同时奇点交易所app的这些数字货币都支持在线交易，每笔交易都有平台进行安全防护，这个奇点交易所平台非常靠谱，操作简单，能让你轻松的赚零花钱。
SGT奇点	　　SGT奇点app是一款在手机上也能操作的区块链赚钱软件。SGT奇点app每天都会有最新的区块链资讯为您提供，大家完成SGT奇点每天规定的任务之后可以赚取大额的佣金，每天早上8点左右将会有一批首发的赚钱任务进行推送。SGT奇点app主要是一些新能源项目的区块链赚钱任务，还是希望各位投资者能够多多的参与进来。
双鱼短视频	　　双鱼短视频app是一款好用的短视频播放软件。在双鱼短视频app中用户可以通过每天看视频赚到不错的收益,在双鱼短视频上我们可以看到非常多的优质的短视频,各种风格和类型的都有,让你刷视频根本停不下来,大家只需要把选择感兴趣的短视频，把双鱼短视频app的文章转发分享在我们自己的朋友圈上，获得朋友的点击都是可以获得现金奖励的。
中融基金	　　中融基金APP，全新上线，
好股票	好股票app里有众多资深投资顾问、权威财经专家为投资者提供个性观点、解读重大财经新闻，洞悉市场热点涉猎的热门板块及股票投资契机。内容专业权威，数据精细挖掘，全面支持用户根据自主喜好与投资风格选择专栏体验与订阅服务。
老虎嗨玩	　　老虎嗨玩app是一款非常靠谱的试完赚钱软件，软件具有海量试完任务，各种类型一应俱全，你可以更好的进行选择，并且软件操作简单便捷，更好的帮您一边玩游戏一边赚钱，同时软件随时随地都可以进行提现，海量新人现金红包等你来领，每天都会发放大量的任务，问卷调查，文章阅读转发，每日运动签到等都多元化赚钱方式，适合宝妈和大学生利用周末或者碎片时间来赚钱哦。
支付通QPOS	　　1、支付通Qpos页面全新改版，以悦动的橙色为主色调，在满足商户收款需求的同时、又重磅推出金融理财服务，带给商户不一样的收款体验。　　2、支付通Qpos金融理财产品是由金融、法律和电子商务等领域专业人才团队量身打造并经国有担保公司担保，为支付通Qpos商户提供更高收益、更高安全、更高灵活的理财产品　　3、支付通Qpos为商户提供收款服务的同时，解决商户在经营时不便办理银行卡转账，信用卡还款、手机充值等业务的燃眉之急。同时也为商户店面无成本投入下增加客流量，提高店面销售额。
掌上基金	　　掌上基金支持2000多支基金在线交易，10000多支公私募基金数据查看，更有专业团队打造的研报和牛基推荐，是您投资理财的最佳帮手。
省点饭店买单结账助手	软件特色
中金财富	　　中金财富app是一款有关投资赚钱的应用软件，中金财富app这里汇集了海量优质投资项目赚钱资源，有了中金财富这款软件，用户就可以更加方便的去所说的查看那些投资项目，在中金财富app这里，用户不仅可以学习到不少的有关投资赚钱的知识，还可以查看自己的收益。
极简速汇	极简速汇app是「极简汇率」旗下产品，是一款面向海外华人提供小额汇款回国服务的 App。帮助海外华人将汇款回国的成本、流程和时间压缩 80% 以上。
步行赚钱	　　步行赚钱DD走路赚钱、运动赚钱、走步多多赚钱等多种玩法集合的新型计步赚钱软件。
来电转	　　来电转APP是一款为全国十几亿用户打造理想软件。来电转app打破传统接电话免费形式，革命性的让用户接电话就赚钱，从而颠覆用户的思维。同时该软件又是全国上千万商家产品宣传推广的理想平台，它彻底打破传统广告模式，颠覆广告行业的理念。
安POS	　　安POS APP是一款全方位移动收款助手，集刷卡、快捷支付、微信、支付宝、云闪付、银联二维码等多种支付方式于一机，为广大商户提供“安全、可靠、简单、便捷”的一站式移动收款服务。是国内领先的移动支付、智慧营销和创新金融的综合性收款终端。
宁证期货掌赢	　　宁证期货掌赢是宁证期货恒生版手机APP，
光速宝	　　光速宝app是一款超级实用的手机支付应用，光速宝app支付操作简单，功能强大，不仅仅只是支付那么简单，同时光速宝app还具有转账、理财等功能。
币世界	　　币世界是一款数字货币投资服务app。币世界app致力于为比特币btc、比特现金bcc/bch、莱特币ltc、以太坊eth等数字货币资产投资者提供及时、全面、专业、准确的币圈动态、币种实时行情、区块链行业新闻、区块链知识科普及交易机构(火币网、OK、币安等)炒币攻略等，帮助大家了解区块链发展趋势及做出正确的投资决策。了解区块链、玩转币圈，上币世界app就够了！
走路去寻宝	　　走路去寻宝app是一款走路都能挣钱的计步赚钱软件，这款及软件既可以帮助大家记录运动数据，从而更好地调理好自己的身体，也可以帮助大家开心赚钱，将每日生活开销赚回来！你只需要每天打开软件，并按时按量进行跑步运动，系统就会自动记录你的步数啦，牛可以凭借自己的运动量兑换金币，金币既可以在平台商城内兑换精美的小礼品，也可以直接兑换成真实收益。
走财运健步	　　走财运健步app是一款支持计步功能、并通过健步领取佣金的应用。用户只需要进行日常的走路就可以赚钱，用户只需要每天到达指定的步数标准，就可以领取到对应的区间步数奖励，将奖励非常了非常多的区间，用户可以通过不同的区间运动来进行奖励的领取，同时可以帮助用户进行每日的步数计量，让用户可以对自己的运动一目了然！
开源手机证券	　　开源手机证券app是一款功能强大、面向普通投资者的专业手机交易软件，除了支持沪深A股，开源手机证券app还提供了全球各市场指数、商品、外汇、港股行情以及专业的资讯内容，本版本同时支持了A股交易功能、开放式基金、融资融券、基金盘后、OTC等功能。
今日黄金	今日黄金app是一款专业的掌上黄金资讯软件，今日黄金app汇聚黄金、白银、原油等业内主流财经媒体资讯，致力于为广大黄金投资者提供全面、周到的服务；选择今日黄金app，日进斗金不是梦！
尺度科技	　　下载尺度app，加入财经知识分享社群，尺度app，与中国的投资者一起分享财经知识干货，尺度app，遇见接地气、接近市场一线的财经资讯。中国私募操盘笔记在尺度app为你呈现。汇聚大咖智慧观点的财经内参每周更新。每个交易日财经早报与你见面。有趣的投资者在尺度app。
快乐支付	快乐支付app是一款全新移动服务APP，以实现随时、随地进行收付款、7*24小时及时到账，保障商户交易安全、资金安全、信息安全，为用户提供便捷全面的移动收单服务。
宁证期货	　　五矿期货app支持南证期货主席金仕达交易系统，以及次席CTP交易系统。期货交易含限价、市价、FOK、FAK；快买快卖；套保、套利交易、显示资金账户信息、持仓信息、成交信息等；开户、客户信息修改、银期转账功能。期货行情提供了上期所、大商所、郑商所、中金所以及能源交易所的所有品种行情，另外包含LME、COMEX、NYMEX等外盘市场的部分品种行情和外盘指数。在信息咨询方面包含财经日历、咨询中心等。
九银E管家	九银E管家app是由九江银行为中小企业量身打造的一款手机银行软件。九银E管家app可以帮助企业用户及时的在平台上面处理相关的银行工作事宜，给你便捷体验。
有一手	　　有一手APP是一款集多功能为一体的为用户提供信息发布中介服务应用软件，长期专注于技术，风控，代记账等服务。
STC生态保护币	　　STC生态保护币正在空投，注册并通过认证，获得矿机一台，邀请补，团补，等级制度，团队化推广！
随行付Plus	　　随行付MPOS正式更名为随行付Plus，信用卡生活从此开始，崭新面貌，更多功能等你体验。
悬赏猫	　　悬赏猫app是一款手机赚钱app软件，在这里你可以做悬赏赚钱，赚得佣金可随时提现。在悬赏猫app你也可以发布悬赏任务，让千万用户体验你的产品!
建行惠懂你	　　建行惠懂你app这是一款建行通过运用互联网、大数据等新技术，为小微企业提供贷款服务的互联网金融应用。客户可在线实时测算贷款额度，了解丰富的贷款产品，享受在线预约开立企业账户，在线办理小微快贷的一站式服务。
尺度	　　下载尺度app，加入财经知识分享社群，尺度app，与中国的投资者一起分享财经知识干货。
陀螺财经	　　陀螺财经app是专注于区块链行业新闻、资讯、价值项目采访报道、围绕创新项目的观点剖析与交流。另设有陀螺区块链知识课堂。力求为您提供及时、全面、专业、准确的资讯，帮助你读懂区块链&未来，发掘优质项目和趋势的价值。
红牛股票	功能介绍
全民付	　　目前推出的是“全民付”版,“全民付”为银联商务有限公司旗下的便民业务品牌,为广大持卡人提供公共事业缴费,信用卡还款,手机充值,账单号支付,卡卡转账,余额查询等多功能业务,从而实现“全民生活便利付”的美好生活体验.　　主要功能：　　1.信用卡还款： 支持23家银行信用卡还款业务和多家银行实时还款业务,操作方便简单,保障还款及时,准确. 支付方式：手机刷卡器（一盒宝）.　　2.公共事业缴费： 用户在手机端输入水,电,煤账单号或拍摄水,电,煤账单条形码就可以进行水,电,煤等公共事业缴费. 支付方式：手机刷卡器（一盒宝）.　　3.手机话费充值： 支持全国范围内的移动,联通,电信手机号码的话费充值业务,提供金额为50元,100元两种金额充值,充值成功后系统会自动发送成功充值短信. 支付方式：手机刷卡器（一盒宝）或无卡支付.　　4.账单号支付： 用户在银联商务签约的网上商城购买商品后,通过在手机端填写账单号即可完成支付.无需开通网银,为担心网络支付安全性的用户提供便利,安全的支付服务. 支付方式：手机刷卡器（一盒宝）.　　5.卡卡转账： 用户不必奔波于各家银行之间存取现金,只要有手机和刷卡器（一盒宝）在手,就可以完成借记卡与借记卡之间的转账业务,包括同城跨行转账业务及异地跨行转账业务. 支付方式：手机刷卡器（一盒宝）.　　6.余额查询： 用户可以随时随地查看任意一张银联借记卡余额,资金存储信息尽在“掌中”. 查询余额方式：手机刷卡器（一盒宝）.　　7.机票订购只要有网络,只要有手机以及刷卡器（一盒宝）.我们就可以随时随地买机票.　　8.地方性业务接入全国省市地方特色业务.让您在“远方”也可以解决家里的烦恼.　　“全民付”让您方便,简单,快乐支付!还等什么?快点下载手机客户端,与好友一起分享移动支付新生活吧!
哈尔滨银行手机银行	　　哈尔滨银行手机银行操作简单实用、安全高效,欢迎安装使用,享受手机银行带给您的全新体验。哈尔滨银行手机银行客户端几乎涵盖了网上银行所有的功能，包括银行账户管理、查询交易、基础理财、自助缴费、转账、基金、国债、理财产品以及信用卡业务等等。　　哈尔滨银行手机银行客户端特色　　1、多渠道整合，统一会员管理　　新一代网络银行对电子接入渠道进行统一整合管理。客户注册为新网银会员后，默认开通各电子渠道。　　2、开通手机动态短信密码验证介质　　为满足电子金融服务的3A性质，为客户提供方便快捷的服务，开通了手机短信动态密码验证方式。使用手机短信动态密码可进行账户小额资金操作。　　3、认证介质统一认证管理　　统一认证管理平台对客户使用的认证介质（二代TOKEN、二代U-KEY，手机动态密码）进行统一管理，会员可灵活选择验证介质在网上营业厅进行各项金融交易。　　4、全新的UI展现　　网上营业厅充分利用UI展现，取消了登录与体验的必然关系，利用电子商务模式销售银行产品，让金融产品商品化，逐步向银行网络化金融服务转变。　　5、常用功能灵活设置　　会员可以根据自身偏好来添加常用功能，避免多层菜单查找的麻烦。　　6、交易限额可自行设置　　新一代网络银行为客户提供了交易限额设置功能，满足了不同客户的实际需求。
上海农商银行	　　为您提供账户管理服务，包括添加或删除手机银行的注册卡号、查询卡余额和交易明细。您可以及时掌握银行卡的余额变化和交易明细。　　- 账户管理：提供手机银行注册卡的添加和删除功能，还可将卡号和手机号进行绑定，在他人给您的手机号转账的时候作为收款账号。　　- 账户余额查询：实时查询账户的余额。　　- 账户明细查询：实时查询账户的交易明细
方正证券小方	　　【轻松开户】
安东环球	安东环球（Anto Global）是全球领先的外汇贵金属投资平台，原油、指数、股票、期货差价合约一站式交易服务，外汇开户首选。
悦走红包版	　　悦走红包版app是一个新出的走路计步赚钱应用，同时也可以喝水打卡赚钱，总之提供的赚钱任务还挺多的，基本上都是从健康的角度打造，悦走红包版对于每个人来说都是适用的。悦走红包版让大众在享受运动、获得健康的同时，让用户每一步都能产生价值。
财咨道	财咨道app由麟龙投顾自主研发出品，是首款将股票行情与短视频功能创意结合的新型应用，使得人人都有机会通过短视频的方式分享自己的股市经验，更仰仗于麟龙在股市深耕多年的经验，为用户提供专业、实时、安全的行情指数及选股分析。
电银碰	电银碰app是一款为商户提供便利收款服务的手机APP，支持多种收款方式。无论您是大中型商户、个体工商户、还是小微商户，都可以通过电银碰app轻松完成收款。电银碰包括硬件设备和客户端软件两部分。无论您身处何处，随时随地开展业务，操作简单方便。
派派种菜	　　派派种菜app是一款种菜获得收益的赚钱类模拟游戏。派派种菜app玩家在游戏中经营着一家农庄，你要收集各种农作物进行培养。精心呵护，浇水施肥，让所有的农作物都能健康茁壮的成长。游戏操作简单易上手，尽快熟悉所有作物的种植方法，逐步扩大你的农场规模，收获更多红包奖励和金币。
章鱼记账	　　章鱼记账app一款轻便、快捷的记账好帮手！支持多账本，满足不同场景日常记账，再也不用担心钱花哪儿了，高效秒记账，收支报表实时分析，让你随时随地掌握资金流向，分类预算设置，消费情况实时提醒。
旅行世界走路赚钱	　　旅行世界--是一款走路轻松赚钱，健康出行，绿色生活。
羚羊财富	　　羚羊财富app是一款提供非常多样的产品可以在线选择的理财软件。羚羊财富app为广大客户提供实时股票查询、安全快速交易、专业股市资讯等服务，羚羊财富app还有理财产品选购、投资顾问咨询、模拟练习、自助业务办理等证券服务，羚羊财富app希望为为广大投资者提供安全、高效、透明的互联网投资平台。
华融证券1账户	　　华融证券1账户app是一款优秀的手机证券服务平台。华融证券1账户手机app专为手机上网客户设计，华融证券1账户基于移动通信网络的数据传输功能来实现用手机进行股票信息查询和交易的新一代无线应用系统，能够提供行情、资讯、咨询信息、大数据等一系列服务，华融证券1账户安卓支持创业板新规的全交易功能最新版app。
运动赚	　　运动赚app是一款运动就能赚钱的软件，只要你走的越多就赚的越多，运动赚app致力于让大家走的每一步路都是有价值的。运动赚app主打走路赚钱，每天运动积攒步数就能获取红包，运动赚app鼓励大家培养更好的健身习惯，每日还可以完成更多的任务来获得收益，让你的生活更加健康，让运动也不会感到枯燥。运动赚app玩法简单，靠运动就能赚钱。
派派农场	　　派派农场新版本是一款网络社交软件，派派农场新版本拥有同城交友，在线语音聊天，抢红包，建立自己的农场，喂养Q萌Q萌的宠物，派派农场新版本还可以“抓”自己的好友来为自己打工等功能，趣味性不断，新鲜感十足。
桌迷藏	　　桌迷藏app是一款手机手账软件，在这款桌迷藏软件上用户可以自己设置喜欢的手账背景和模板，还可以随意更改，用户就可以将设计的手账直接按照图片或者文字的模式进行分享或者打印，对于喜欢将手账设置成纸质版的就可以保存下载进行打印，而且上面很多模板都是免费的，有需要的小伙伴可以下载使用。
集金期货通	　　集金期货通是杭州卓赢科技有限公司(以下简称"卓赢科技")自主开发运营的app.立志于为国内金融机构和广大投资者提供金融产品软件及个性化技术解决方案,致力于打造国内一流的金融信息服务商,满足广大投资者的多元化投资服务需求.
上海农商银行直销银行	功能介绍
国泰基金	　　1 什么是基金账户？
简易家庭记账本	　　为您提供通过简单的操作就能实现迅速记账的服务，并为您分析您的财务状况。　　在本软件中为你提供以下服务：　　◆收入，支出的记录，查询，编辑　　◆每月的收支状况的统计和分析　　◆随时可以查询剩余金额以及每个项目的支出比例
PP理财	　　1、低门槛，高收益：　　100元起即可投资任意理财产品，高达50倍银行活期存款收益；　　2、交易安全，操作简单：　　身份证，交易密码，银行卡多重认证。率先使用手势密码避免复杂操作，投资理财两不误；　　3、风险保证，投资安心:　　浦发银行5000万风险准备金，国有大型保险公司产品保险，国有资产交易所全程托管，十年风控经验的专业团队。　　【平台资质】　　广东省互联网金融协会会长单位　　广东省商业保理协会会长单位　　国际认证机构德国莱茵TUV集团A+信用评级平台　　【一大波活动逼近中???】　　1、首投送理财基金，周末参与还翻倍送；　　2、签到积分兑换VIP、理财基金和提现券等。　　还有更多活动，正在火热进行中，敬请留意站内信息！
模拟炒股	　　中国地区最受用户喜爱的炒股应用！
刷客宝分销版	　　刷客宝app主要用于刷脸支付业务发展，用户可线上了解刷脸支付资讯与官方政策，获取商户落地指导信息，在app上购买刷脸设备成为刷脸支付代理。
平安E企宝	软件特色
掌赚兼职	　　掌赚兼职是一款用手机做任务、做兼职、发布悬赏任务、帮人得赏金的手机赚钱平台！
融金生活	　　融金生活app是一款超级简单的赚钱平台。融金生活app平台里面有多种赚钱的任务，用户随时都可以在线领取完成，而且平台上的任务都是非常简单的，很快就可以完成，也不会花费太多的时间，只需要在闲暇的时候做做任务就可以了，还可以邀请自己的好友跟你一起做任务赚钱，还可以获得一定的积分，积分是可以在平台上兑换奖励的哦。
火信	　　火信app是一款专门为区块链行业打造的一个聊天社区平台，
基本面	　　基本面app致力于为广大投资爱好者提供多方面的选股决策建议，帮助投资者能够从中获取最新投资交易情报，不错过任何可投好时机；
源达慧选股	　　“源达慧选股”是一款为用户解决“分析难”、“选股难”的决策型辅助炒股软件。
优旺科技	　　优旺科技抢单平台十分靠谱，优旺科技app是一款值得用户来入手的手机自动抢单赚钱的软件，上面每天的任务多的做不完，每天都有新的商家入驻下单，任务做起来特别简单，单价也是全网范围内十分的高。
字节传媒	　　字节传媒app里面的点赞任务很多，而且会不断的更新，大家不用担心没有任务做。主要是抖音作品点赞、关注和分享，每天利用自己空闲的时间就能够赚到点收益，还是很不错的，至少零花钱还是可以保证的。所有的用户都需要账号登录进来，新用户直接手机号注册，然后绑定自己的账户，方便之后进行提现。
押呗	押呗app是一款服务便捷、物管安全的互联网+数码寄存专业应用。彻底解决大都市商旅流动人士数码物品携带不便的烦恼，同时押呗app拥有独立智能二手数码产品估价系统，通过旧机寄存为用户提供数百到几千不等的小额变现服务。
CBCF	CBCF，正在空投，免费注册并通过认证，获得矿机一台，邀请补，等级制度，团队化推广!
恒生个人理财	　　私人银行
工商银行信用卡	　　工商银行信用卡app是一款中国工商银行信用卡官方客户端。工商银行信用卡app全新升级的2.0版本集生活、消费和金融服务于一体，是整合支付、融资、丰富生活消费场景的综合化移动智能服务平台。无论您是否是工商银行持卡人，都可享受工商银行信用卡app的便捷服务。工商银行信用卡app四大功能频道，汇集丰富的用卡及生活场景，让金融触手可及。
朝阳智投	　　朝阳智投APP(66966.cn)，专注线上投顾服务，智能工具+人工服务，解决一亿股民炒股需求。
巴中农商银行	基本简介
亿联银行	　　亿联银行定位为“以客户为中心，以科技为驱动、发展普惠金融为宗旨”的智能网络银行，通过大数据、人工智能、云计算等科技技术，在“衣食住行用”等各种场景中移动互联各个平台，为广大个人消费者和小微企业主、小微企业提供存款、贷款、理财、汇兑等金融服务。
恒大交易	　　恒大交易一款专业的金属现货产业平台。由恒大金属交易中心股份有限公司推出。恒大交易app为用户带来最新的贵金属现货投资咨询、行情报道等信息，帮助用户掌握一手资源，软件由省政府正规批文，安全可靠。
珠江直销银行	
小米分期	　　小米贷款app是小米官方全新上线的贷款应用手机客户端，小米贷款app为用户提供纯信用贷款服务，这款小米贷款app获贷简单，仅需“认证-申请-放贷”3步搞定。整个过程不到2分钟，规范透明。小米贷款app按天计算利息也很灵活，用起来没压力。
广州农商银行直销银行	功能介绍
复利大师	　　为配合学员学习，深圳启富证券投资顾问有限公司投入人力物力，潜心打造了一款证券资讯终端，命名为复利大师。 
复利大师内含大盘分析、操作策略、专业研究报告、财经内参等栏目，同时可实现在线交流，专注于为投资者提供经市场检验的交易策略，为高含金量证券资讯产品。
鑫梦享	　　“鑫梦享”APP是南京银行消费金融中心精心打造的在线贷款服务应用，
万和手机证券	　　万和证券财易通同花顺版包括普通AB股交易、融资融券、股票质押、银证转账、IPO新股申购、开放式基金等业务。
融易汇新版官方	　　融易汇手机客户端是齐鲁证券以客户为中心，不断提升客户体验而重点推荐使用的集证券交易、融资融券交易、OTC交易和理财等于一体的交易与理财服务移动终端； 提供投资日历、图文F10、当日要闻、自选股资讯、全球指数等增值服务。
中银国际	　　"中银国际"是中银国际证券精心打造的移动理财终端，基于无线网络应用技术，为广大的手机证券客户提供实时行情、股市资讯、在线交易和在线客服等理财服务。"中银国际"安全快捷、操作简便、功能丰富、免费使用，您只需配备一部可以上网的手机，即可享有中银国际证券专业的理财服务。
口袋贵金属	　　1.）全方位报价提醒，麻麻再也不担心我错过进场点位。
信用查询	　　1、个人基本信息：包括姓名、证件类型及号码、通讯地址、联系方式、婚姻状况、居住信息、职业信息等;
东方红	　　1、账户查询
PP理财HD版	　　1、低投资门槛，高年化收益：
华澳信托	华澳信托app是集账户管理、首页产品推介、产品预约、产品信息查询、资产查询等功能于一体的移动金融平台，华澳信托app致力于为客户提供优质、便捷、放心的服务。
爱股票	　　爱股票是一家为投资者提供选股策略、投资组合、实时行情、证券资讯等服务的移动互联网公司，主打股市投资者教育、高手直播交流社区、以及证券自媒体分享平台。
大蒜电子盘	　　大蒜电子盘交易软件是一款非常不错的投资赚钱软件，在大蒜期货电子盘里各位用户能够看到最新最火的投资项目，而且还有专家坐镇为大家讲解，不会让你错过任何一个赚钱的机会。使用大蒜电子盘交易软件不仅能够看到全球的金融最新资讯，大蒜电子盘交易软件还能够看到最新的区块链走势图，更有专业专家在线坐镇为大家带来最全面的分析，帮助大家投资成功！
广东华兴手机银行	官方介绍
火币行情宝	　　火币行情宝从行业头条、交流圈子等角度，为区块链用户提供深度的行业内容，帮助用户快速了解数字货币行业动态。
富途牛牛	　　【三大行情】A股、港股、美股行情，一网打尽
松树赚	　　松树赚app是一款最新上线，还热乎着的手机任务赚钱平台。大家在松树赚钱app这里可以获得很多不同的赚钱任务，收益都是杠杠的，另外松树赚app只需要简单地通过完成任务就可以获得对应的奖励啦，不同职业只要你有空闲的时间都可以参与进来，轻轻松松一个月的零花钱就可以赚出来啦，新人注册还赠送超多的现金奖励，加入进来不要犹豫啦。
优米宝	功能介绍
四川农信(蜀信e)	　　个人财务一目了然
工银融e联	　　近日，工商银行携手中国联通推出专属手机卡DD工行e卡。该卡推出超值套餐，为广大用户提供多样增值服务。
京东金条	　　京东金条属于个人贷款类，费率：按日计息0.05%（活动期间0.04%）；违约金费率：0.075%（活动期间0.06%)；如有逾期，则加收违约金0.02%，为借款利息的50%。总的来说，京东金条利息比白条要高！！借款期限在操作的时候可以选择。
宁波银行直销银行	　　直销银行 描述　　宁波银行旗下直销银行投融资平台官方APP，在业界领先的风控体系保障下，结合全球金融发展和互联网技术创新，提供专业可信赖的创新型高收益投融资理财服务，为您获取更多更安全的收益，实现财富增值！
DOGE狗狗币	　　广告汪，全球第一款狗狗币DOGE落地式应用项目
银河玖乐	　　玖乐是一款中国银河证券为你精心打造的安卓手机平台证券交易系统，玖乐android版集行情、交易、咨询、服务多种功能于一体，还优化了个股搜索处理机制，提升了个股信息显示效率，致力于为你带来快乐的理财之旅！　　银河“玖乐”主要特色功能：　　1.及时的多市场行情、资讯信息；　　2.稳定、安全、高效的多品种交易功能；　　3.实时的大势研判、盘中播报、个股研报、个股诊断等银河特色产品；　　4.图形与列表组合展示、关联快捷便利操作、具有与iPhone体验高度结合等特色操作优势；
蓝狐接码	　　蓝狐接码app是一款全新的在线编码和赚钱平台。蓝狐接码软件内置的超级多任务资源，庞大的任务分类，用户可以直接自由地免费获得主页，并根据需要完成它们，从而快速赚钱，赚钱一路走来，轻松，稳定，蓝狐接码致力于为您带来一款软件，实现一路盈利!这款软件可以帮助用户们领取到各种的赚钱任务，丰富的任务根据自己情况自由挑选，完成任务就能获得可观的收入，每天只需要一点点时间就能轻松赚钱。
招商智远理财	更新日志
ourDeFi	　　ourDeFi app是一个全球化的去中心金融服务平台
中本聪挖矿	　　中本聪挖矿app即将开挖，抓紧注册中本聪挖矿抢先机！
exczc交易所	　　exczc交易所app是一款非常权威专业的数字资产交易平台。exczc交易所为全球用户提供数字货币交易服务，币币交易服务，exczc交易所最新版还可以第一实际查询币圈走势情况，很多行业内的信息快讯全都有，轻松在线就能进行理投赚钱，在比较短的时间内还能帮你抓到更多的商机哦，金融动态超多，实时更新推送提供！
中国银行	　　中国银行手机银行Android客户端软件是中国银行针对Android手机用户推出的手机银行服务，提供包括账户管理、转账汇款、投资理财、信用卡、账单缴付、电子支付等金融服务，以及优惠活动、网点查询、掌聚生活、自助注册、存贷款利率、外汇牌价、理财产品等多项增值服务，方便您随时、随地、随心地享用中国银行专业金融服务。　　本软件为免费下载软件，支持的固件版本为2.3或更高版本。
浦发手机银行	　　上海浦东发展银行推出手机银行客户端软件（中国移动浦发银行借贷合一联名卡专用版），无论任何品牌电信运营商网络或无线WIFI网络都可轻松登录,“手机银行，乐在指尖”！
同花顺股票	　　同花顺(300033)手机炒股 股票软件是市场上行情交易最快、数据最全、支持券商最多、领先支持沪港通，最受股民欢迎的完全免费的炒股(金融/投资/理财/证券)软件。　　【炒股必备】　　最多券商：同行业中支持全国最多券商在线交易　　(如广发证券、东吴证券、方正证券、光大证券、国泰君安、银河证券、申银万国、中信证券等)　　闪电下单：分时快买快卖，投资下单快人一步　　新股申购：随时随地申购新股，收益一丝不落
ETHP以太原力	ETHP以太原力正在空投，注册并通过认证，领矿机三台，邀请补，邀请扩散收益，邀请扩散收益，阶梯团队收益，星级达人式制度，团队化推广！
云创共享	　　云创共享app是付临门的战略合作平台，在传统支付行业日趋衰落的形式下，云创共享app平台融合支付传统模式和联盟模式的优势之处，努力营造一个良性的、生态的新支付环境，解决现有支付环境的痛点与不足，让支付人真正拥有一个自己的创业平台。
财联社	　　财联社官方app全面监控全球证券市场资讯，财联社24小时滚动播报为投资者提供365天24小时不间断的电报快讯。财联社以“快速、准确、权威、专业”为准则，提供财经资讯、数据分析、专家咨询等全方位的金融信息服务，已成为机构和私募投资的首选工具。
国都交易宝	　　超低佣金：港股佣金仅万3，转户按原券商收费五折
伯乐创投	伯乐创投app是一个正规的创新型互联网天使投资推荐平台，伯乐创投app旨在发挥自身专业优势，帮助广大民众全民参与（类似于众筹），投到目前尚在萌芽期、但未来发展潜力巨大的互联网创业公司，小投入大回报、四两拨千斤，成人达己、合作共赢！
OK淘金	功能介绍
金十数据	　　金十数据手机版app是一款专业的财经资讯软件，金十数据手机版app提供全球最新行情资讯，金十数据手机版app满足不同人群需求，各项数据显示一目了然，原创编辑独家翻译带你解析新内容。
基金大师	软件介绍
一木记账	　　一木记账app简约而不简单的智能记账软件。通过自然语言处理算法，可从一句话识别出账单时间、分类详情、金额等关键信息，通过手动输入或语音输入等方式输入一句话可实现极速记账。
有鱼金服	　　有鱼金服是一个安全专业的互联网理财平台，专注打造优质基金投资体验。在有鱼金服手机版中用户可以享受一站式基金投资服务，全方位、多角度比较，选基更省心，实时取现，快速到帐。
港版支付宝	　　支付宝宣布推出香港版电子钱包DD支付宝HK，据悉，这是支付宝第一次发布境外版App。
支付宝9.9版本	　　在支付宝app你可以享受消费打折、为家人建立亲情账户，跟好友建群互动......这将是一个3.5亿实名用户共同生活其中的一站式生活平台。
熊猫记账	熊猫记账app是一款采用卡片式风格纯记账软件，功能丰富实用，日账、周账、月账、年账，一应俱全，还有简洁实用的饼状图报表等，并实现了自动账单同步到云端，即使换了手机也能轻松的同步账单数据，超级简单实用，熊猫记账，生活记账一个搞定！
资金保	软件特色
步行赚钱	　　步行赚钱DD走路赚钱、运动赚钱、走步多多赚钱等多种玩法集合的新型计步赚钱软件。
光鹰视频	　　光鹰视频app是一款短视频类的软件，通过光鹰视频app你可以分享你的生活、分享购物和消费体验的一个原创视频分享，同时也可以在光鹰视频app这里认识到更多朋友，用户可以根据自己的喜好观看内容，同时还能赚钱，是不是很厉害呢。
赚钱小项目	赚钱小项目是为大家分享的一款做任务赚钱的手机软件，每天推荐优质的赚钱项目，用户可以通过打字、看新闻、走路、发悬赏任务轻松赚收益，一元即可提现，没有任何手续费用，需要的朋友欢迎下载体验吧。
期货进阶宝	
柠檬喝水	　　柠檬喝水app是一款最近刚上线不久的手机赚钱软件，通过最简单的喝水方式，全民参与的赚钱项目。这款软件采用的最新的技术能力，通过统计大家每天的喝水情况让用户们获得长期稳定的收益。是一款一举两得的线上软件，一边可以帮助您养成良好的生活习惯，另一方面还有很多的零花钱可以赚取。全家人每天坚持打开使用，收益就是成倍的增长哦。
金鼠引流	　　金鼠引流app是一个免费推广引流，金鼠引流还能做任务赚钱的平台，在这里是可以免费发布广告的，并且还有悬赏板块可以接任务做，金鼠引流平台还开设了超高的推广奖励，人脉广的小伙伴进行适当的推广，也能获得不错的收益。感兴趣话一定要进行尝试。
中国网赚联盟	　　中国网赚联盟app提供最新免费网赚项目,网赚兼职及网上最靠谱赚钱的方法;
起源库	　　起源库app提供赚钱福利，在这里有大量任务等待你来完成，一旦顺利完成任务就能获得相应的积分奖励，
裕民银行	　　江西裕民银行app全新上线，新服务、新体验，为你而来。
荣耀任务	　　荣耀任务app是全新上线的一款兼职做任务赚收益平台，玩家通过荣耀任务平台接收任务，完成即可获得高额佣金，你只需动动手指，按要求完成系统派发的工单任务就可以轻轻松松的赚钱，新手用户也可以很快的上手，不用过多的担心，荣耀任务这里所有的任务单价佣金都是各不相同的，根据难度、完成的时间决定。
央视财经	　　《央视财经》是CCTV财经频道官方移动媒体应用，央视财经app以专业财经信息为核心内容，以生活服务和消费时尚为辅助内容，为用户免费提供更多、更全的财经信息资讯。这款央视财经app提供丰富的财经资讯点播、预告、搜索和分享服务，24小时滚动更新，让你随时随地获取财经新闻资讯。
极速短视频	　　极速短视频app是一款更为好用的短视频分享兼职平台，极速短视频app能提供更为精彩的短视频内容去分享查看，直接分享到多个不同的社交圈中即可，每一次的分享都是有奖励的，所以会给大家带来更为独特的兼职新方式，全新的短视频都能在这里浏览，比较的方便！
多多悬赏	　　多多悬赏是一款集互助砍价和走路赚钱和自由发布任务的平台，可以帮别人砍价赚取金币，也可以自己发布砍价任务，让大家帮你极速砍成，走路赚钱，用户在多多互助这款软件可以轻松赚钱，每天只需走路就能轻松赚取收益，每天签到还有金币奖励，金币可以用来兑换奖励！
惠支付商户版	　　惠支付商户版是四川农信为特约商户量身打造的一款通用的支付收单工具。
天星金融	　　小米天星金融app由小米官方推出的手机在线金融服务平台，天星金融主要是为各位用户提供理财、保险、借贷等等方面的服务。在这里，可以帮你解决关于“钱”的问题。天星金融旨在为米粉和用户提供安全、快捷、方便的金融科技服务，并致力于成为全球米粉和新制造业的全面金融伙伴。
白马财经	常见问题
这厮有礼	　　这厮有礼是一款在线调研类APP，用户可以参与在线调查并获得奖励。用户接取任务完成任务既可以获取奖励，单价高，提现迅速
莱月再生	　　莱月再生app是一个为再生资源行业提供金融监管解决方案的平台。构建多维度的再生资源行业生态，为生态中的所有成员提供在线支付、电子合同签约、供应链金融等服务。
睿投科技	　　睿投科技app是针对短视频设计的辅助软件，睿投科技软件的功能十分强大，可以给用户批量进行视频点赞，让用户能够快速获得点赞数量的任务，有了睿投科技app用户会释放双手，自动为短视频点赞。各大主播平台发布作品以及对用户的抢夺需要点击率、点赞率！而睿投科技这一自主研发的手自一体、及时切换IP点赞机器人应运而生，睿投科技平台合作对象包括短视频、快手、火山、西瓜视频、微视等短视频自媒体平台。睿投科技app为以上合作对象提供网红推广视频自动点赞平台，发布任务，睿投科技软件招募点赞能手，从中赚取佣金差价。
甜橙理财	　　1. 平台更安全
华澳信托	华澳信托app是集账户管理、首页产品推介、产品预约、产品信息查询、资产查询等功能于一体的移动金融平台，华澳信托app致力于为客户提供优质、便捷、放心的服务。
一贯	　　万贯家财，始于一贯。一贯是面向个人客户推出的专业金融服务平台。平台完美均衡“安全”与“收益”，提供最安全的高收益理财产品。一贯，让财富增值更简单、更省心！
收钱吧	　　收钱吧应用是专为线下中小商户打造的一站式收款工具，集成支付宝、微信支付以及银行卡收款等多种收款服务，手机就是POS机。　　1、支付宝扫码收款　　2、微信扫码收款　　3、银行卡刷卡收款　　4、银行卡余额查询　　5、交易记录查询　　6、消费交易撤销
爱股票	　　爱股票是一家为投资者提供选股策略、投资组合、实时行情、证券资讯等服务的移动互联网公司，主打股市投资者教育、高手直播交流社区、以及证券自媒体分享平台。
基金豆	　　多平台买基金，查看收益不方便？数据更新不及时，天天刷屏等净值？整体持仓不明晰，投资属性不可知？试试基金豆，解决以上基金管理烦恼。
大蒜电子盘	　　大蒜电子盘交易软件是一款非常不错的投资赚钱软件，在大蒜期货电子盘里各位用户能够看到最新最火的投资项目，而且还有专家坐镇为大家讲解，不会让你错过任何一个赚钱的机会。使用大蒜电子盘交易软件不仅能够看到全球的金融最新资讯，大蒜电子盘交易软件还能够看到最新的区块链走势图，更有专业专家在线坐镇为大家带来最全面的分析，帮助大家投资成功！
广东华兴手机银行	官方介绍
优米宝	功能介绍
富途牛牛	　　【三大行情】A股、港股、美股行情，一网打尽
松树赚	　　松树赚app是一款最新上线，还热乎着的手机任务赚钱平台。大家在松树赚钱app这里可以获得很多不同的赚钱任务，收益都是杠杠的，另外松树赚app只需要简单地通过完成任务就可以获得对应的奖励啦，不同职业只要你有空闲的时间都可以参与进来，轻轻松松一个月的零花钱就可以赚出来啦，新人注册还赠送超多的现金奖励，加入进来不要犹豫啦。
四川农信(蜀信e)	　　个人财务一目了然
工银融e联	　　近日，工商银行携手中国联通推出专属手机卡DD工行e卡。该卡推出超值套餐，为广大用户提供多样增值服务。
京东金条	　　京东金条属于个人贷款类，费率：按日计息0.05%（活动期间0.04%）；违约金费率：0.075%（活动期间0.06%)；如有逾期，则加收违约金0.02%，为借款利息的50%。总的来说，京东金条利息比白条要高！！借款期限在操作的时候可以选择。
DOGE狗狗币	　　广告汪，全球第一款狗狗币DOGE落地式应用项目
招商智远理财	更新日志
蓝狐接码	　　蓝狐接码app是一款全新的在线编码和赚钱平台。蓝狐接码软件内置的超级多任务资源，庞大的任务分类，用户可以直接自由地免费获得主页，并根据需要完成它们，从而快速赚钱，赚钱一路走来，轻松，稳定，蓝狐接码致力于为您带来一款软件，实现一路盈利!这款软件可以帮助用户们领取到各种的赚钱任务，丰富的任务根据自己情况自由挑选，完成任务就能获得可观的收入，每天只需要一点点时间就能轻松赚钱。
广告汪	　　广告汪APP- 正在空投中,0撸300元,注册实名送40天挖20000狗狗币矿机,团队化收益
ourDeFi	　　ourDeFi app是一个全球化的去中心金融服务平台
BTCs挖矿	　　BTCs挖矿平台是通过矿机来进行收益的。而且用户每天在BTCs挖矿app上都是可以挖矿的，动动你的小手指就可以轻松的有收入，你想知道自己的收入在个人中心就能很快的看到。BTCs挖矿软件是非常方便的，第四季，BTCs挖矿即将开挖，抓紧注册抢先机！量不多
卡牛信用卡管家	　　【多重保障】　　大品牌打造，用户数据安全有保障；　　支持狠到位，随手网服务有口皆碑；　　数据非实名，用户与数据无任何关联；
exczc交易所	　　exczc交易所app是一款非常权威专业的数字资产交易平台。exczc交易所为全球用户提供数字货币交易服务，币币交易服务，exczc交易所最新版还可以第一实际查询币圈走势情况，很多行业内的信息快讯全都有，轻松在线就能进行理投赚钱，在比较短的时间内还能帮你抓到更多的商机哦，金融动态超多，实时更新推送提供！
浦发手机银行	　　上海浦东发展银行推出手机银行客户端软件（中国移动浦发银行借贷合一联名卡专用版），无论任何品牌电信运营商网络或无线WIFI网络都可轻松登录,“手机银行，乐在指尖”！
中国银行	　　中国银行手机银行Android客户端软件是中国银行针对Android手机用户推出的手机银行服务，提供包括账户管理、转账汇款、投资理财、信用卡、账单缴付、电子支付等金融服务，以及优惠活动、网点查询、掌聚生活、自助注册、存贷款利率、外汇牌价、理财产品等多项增值服务，方便您随时、随地、随心地享用中国银行专业金融服务。　　本软件为免费下载软件，支持的固件版本为2.3或更高版本。
同花顺股票	　　同花顺(300033)手机炒股 股票软件是市场上行情交易最快、数据最全、支持券商最多、领先支持沪港通，最受股民欢迎的完全免费的炒股(金融/投资/理财/证券)软件。　　【炒股必备】　　最多券商：同行业中支持全国最多券商在线交易　　(如广发证券、东吴证券、方正证券、光大证券、国泰君安、银河证券、申银万国、中信证券等)　　闪电下单：分时快买快卖，投资下单快人一步　　新股申购：随时随地申购新股，收益一丝不落
ETHP以太原力	ETHP以太原力正在空投，注册并通过认证，领矿机三台，邀请补，邀请扩散收益，邀请扩散收益，阶梯团队收益，星级达人式制度，团队化推广！
伯乐创投	伯乐创投app是一个正规的创新型互联网天使投资推荐平台，伯乐创投app旨在发挥自身专业优势，帮助广大民众全民参与（类似于众筹），投到目前尚在萌芽期、但未来发展潜力巨大的互联网创业公司，小投入大回报、四两拨千斤，成人达己、合作共赢！
OK淘金	功能介绍
基金大师	软件介绍
欢乐赚赚赚	　　欢乐赚赚赚app欢乐赚赚赚app是一款休闲赚钱软件，走路赚钱、运动赚钱、阅读赚钱等多种赚钱活动在这里都可以找到，帮助用户进行赚钱打造.走路赚钱、运动赚钱、刮卡赚钱、种水果赚钱、看文章赚钱、早起赚钱、购物赚钱，玩手机就能轻松赚零钱！欢乐赚一款专门为用户打造的网赚APP，你的第二份工资就在欢乐赚！
多尚记账	软件介绍
优旺科技	　　优旺科技抢单平台十分靠谱，优旺科技app是一款值得用户来入手的手机自动抢单赚钱的软件，上面每天的任务多的做不完，每天都有新的商家入驻下单，任务做起来特别简单，单价也是全网范围内十分的高。
字节传媒	　　字节传媒app里面的点赞任务很多，而且会不断的更新，大家不用担心没有任务做。主要是抖音作品点赞、关注和分享，每天利用自己空闲的时间就能够赚到点收益，还是很不错的，至少零花钱还是可以保证的。所有的用户都需要账号登录进来，新用户直接手机号注册，然后绑定自己的账户，方便之后进行提现。
零元赚	　　零元赚首码以出，悬赏无限代
ZCBX众创链	众创链ZCBX正在空投，矿池排队模式，注册并通过认证，获得500矿池，，团补，星级达人式制度，团队化推广！
EKC恩克币	EKC恩克币正在空投，ATR_BKKI模式，注册并通过认证，获得永久矿机一台，等级制度，推广扩散收益，团队化推广！
海洋公链	海洋公链NOC正在空投，注册并通过认证，获得矿机一台，邀请补，团补，星级达人式制度，团队化推广!
ACH信息币	ACH信息链正在空投，注册并通过认证，获得矿机二台，推广扩散激励烧，团补，星级达人式制度，团队化推广！
恒生个人理财	　　私人银行
工商银行信用卡	　　工商银行信用卡app是一款中国工商银行信用卡官方客户端。工商银行信用卡app全新升级的2.0版本集生活、消费和金融服务于一体，是整合支付、融资、丰富生活消费场景的综合化移动智能服务平台。无论您是否是工商银行持卡人，都可享受工商银行信用卡app的便捷服务。工商银行信用卡app四大功能频道，汇集丰富的用卡及生活场景，让金融触手可及。
朝阳智投	　　朝阳智投APP(66966.cn)，专注线上投顾服务，智能工具+人工服务，解决一亿股民炒股需求。
股管家	　　为用户提供7X24小时实时财经新闻资讯，做有深度的财经资讯，推有重磅的财经头条！
蜻蜓点金	　　蜻蜓点金app原名“中信建投证券APP”，蜻蜓点金app是中信建投证券官方为广大投资者倾力打造的炒股/投资/理财/基金/证券/财经资讯/金融软件，致力于为广大交易者提供极速、安全、优质、全面的股票、投资、理财平台。极速交易行情、丰富理财产品、独家精彩资讯、线上业务办理、金牌投顾互动、智能选股家族、大数据分析、云端同步自选股，尽在蜻蜓点金APP！
巴中农商银行	基本简介
亿联银行	　　亿联银行定位为“以客户为中心，以科技为驱动、发展普惠金融为宗旨”的智能网络银行，通过大数据、人工智能、云计算等科技技术，在“衣食住行用”等各种场景中移动互联各个平台，为广大个人消费者和小微企业主、小微企业提供存款、贷款、理财、汇兑等金融服务。
恒大交易	　　恒大交易一款专业的金属现货产业平台。由恒大金属交易中心股份有限公司推出。恒大交易app为用户带来最新的贵金属现货投资咨询、行情报道等信息，帮助用户掌握一手资源，软件由省政府正规批文，安全可靠。
珠江直销银行	
小米分期	　　小米贷款app是小米官方全新上线的贷款应用手机客户端，小米贷款app为用户提供纯信用贷款服务，这款小米贷款app获贷简单，仅需“认证-申请-放贷”3步搞定。整个过程不到2分钟，规范透明。小米贷款app按天计算利息也很灵活，用起来没压力。
广州农商银行直销银行	功能介绍
中银消费金融	平台成立于2010年6月，是中国银行的附属公司，总部位于上海，是经中国银监会批准设立的全国首批消费金融公司之一，也是上海第一家消费金融公司。公司秉承“信用开启美好未来”理念，努力创造“方便、快捷”的融资服务体验，致力于成为消费导向型的专业化个人融资渠道，贴近新一代消费群体的需求，带来更便捷、更专业、更灵活的消费融资及服务。目前，中银消费金融的合作商户及网点已达500多家，遍布全国80多个城市。
赢火虫	　　赢火虫整合了法律服务、民间资本的两类资源，开发了“免息贷”、“案源库”两款核心产品。“免息贷”致力于为个人、中小微企业提供低成本、高效率的诉讼费用在线融资服务;
复利大师	　　为配合学员学习，深圳启富证券投资顾问有限公司投入人力物力，潜心打造了一款证券资讯终端，命名为复利大师。 
复利大师内含大盘分析、操作策略、专业研究报告、财经内参等栏目，同时可实现在线交流，专注于为投资者提供经市场检验的交易策略，为高含金量证券资讯产品。
马克巴	　　1.沟通更及时
中泰齐富通专业版	　　1.交易功能全面升级，全新视觉体验，交易更流畅！
鑫梦享	　　“鑫梦享”APP是南京银行消费金融中心精心打造的在线贷款服务应用，
恒大金服	恒大金服app是恒大集团旗下的互联网金融平台。拥有互联网支付、基金支付、预付卡、基金销售、保险经纪、保理、私募基金等相关金融牌照及业务经营资质。恒大金服app所对应资产安全性由上市公司担保，投资资金全程接受银行监管，风险管理体系具有国际金融机构专业水准，预期年化收益优于同业。
融易汇新版官方	　　融易汇手机客户端是齐鲁证券以客户为中心，不断提升客户体验而重点推荐使用的集证券交易、融资融券交易、OTC交易和理财等于一体的交易与理财服务移动终端； 提供投资日历、图文F10、当日要闻、自选股资讯、全球指数等增值服务。
中泰齐富通	功能介绍
中银国际	　　"中银国际"是中银国际证券精心打造的移动理财终端，基于无线网络应用技术，为广大的手机证券客户提供实时行情、股市资讯、在线交易和在线客服等理财服务。"中银国际"安全快捷、操作简便、功能丰富、免费使用，您只需配备一部可以上网的手机，即可享有中银国际证券专业的理财服务。
东方红	　　1、账户查询
世基黄蓝带	　　世基黄蓝带app打造平民智能量化策略交易平台，黄蓝带手机版让普通投资者也能随时随地、快速轻松地学习、使用炒股策略，并且云端托管后可时时盯盘，把握最佳买卖时机，世基黄蓝带标准版让你一边省时省力省流量，一边赚钱。
云账本	软件介绍
国美黄金	　　国美黄金是多边金宝商业有限公司旗下的黄金金融业务品牌及产品名称，
发财鸡	　　发财鸡安卓版是一款区块链赚钱软件，在这里，用户通过推广邀请好友、购买商城商品能兑换发财鸡，微信登录送10000个鸡蛋，可以变成天堂鸡获取收益。实时在线推广获取收益。变成发财鸡的时候还能对其他玩家的小鸡进行抓取哦。
以太猴	　　以太猴app主打挖矿赚钱，用户注册就有矿机领取，业余时间随时来赚钱~靠谱矿机项目，让对区块链感兴趣的朋友们可以放心来赚零花钱，无需任何投资，每天都有稳定收益等着你~来这里领养以太猴，参与宠物互动、交易等都能获取利益~更有推广项目上线，小伙伴们可以加入团队，不断发展下线，分红奖励拿到手软。
创易兼职	　　创易兼职APP是一个非常方便的兼职平台，为大家提供的海量兼职任务，随时都可以在这个平台上面选择自己感兴趣的任务。在这里面每一个兼职任务都是经过了严格的审核，而且每一个任务都有详细的介绍，选择合适的兼职岗位报名，将你感兴趣的形式收藏，在平台上面做完兼职之后，系统还会自动为大家统计收入。
68赚网	　　68赚网手机版，只需每天浏览广告、点击广告、悬赏任务，都可以轻松获得金币，兑换成现金，大家速度来做，赚零花钱，赚生活费，我每天花1小时做任务。
方喜元	　　方喜元app每天都有很多商家来发布任务，用户就根据任务来完成
基金E站	　　1、每日净值：公司基金产品每日净值、涨跌幅、历史净值走势等信息的快速查询;
友金所	　　【认识友金所】 友金所由用友网络（股票代码：600588）、深圳力合金控与银行专家管理团队联合设立。作为用友集团成员企业，友金所致力于提供专业的全流程金融信息服务，打造安全、便捷、可信的综合性投融资平台，为投资客户提供安全、本息担保、收益稳健的互联网理财服务。 友金所作为专业的互联网金融P2P理财平台，收益高达15%，更有YY理财、友金e富等期限灵活理财产品，总有一款适合您。
金挚	　　金挚APP是金智东博（北京）教育科技有限公司引入权威银行专家团队和顶尖互联网团队，历时两年的调研和开发，针对金智用户的营销需求专属定制的营销策略神器。
深农商企业版	　　深圳农村商业银行专为您打造的企业手机银行客户端，为您的企业带来轻松便捷的移动金融体验。简单，更懂你!
牛牛赚	　　牛牛赚app是一款最新上线的微信挂机赚钱APP，效率惊人享有非常可观挂机收益。
平安证券	　　平安证券有限责任公司是中国平安（保险）集团股份有限公司旗下重要成员，前身为1991年8月创立的平安保险证券业务部，目前拥有平安财智投资管理有限公司，平安期货有限公司、中国平安证券（香港）有限公司，平安磐海资本有限责任公司共四家子公司。
网商银行	软件特色
温州银行	　　温州银行手机银行客户端（安卓版）是根据Android系统特点而开发的移动金融服务系统，利用手机为载体，通过手机上网登录客户端操作，作为一种崭新的电子银行服务渠道，更加突出了“随时随地、贴身快捷、方便时尚”的独特性，真正实现了“Whenever、Wherever（任何时间、任何地点）”的新型电子银行服务理念。
南京银行	　　本产品是南京银行为Android用户量身打造的新一代手机银行,使客户可以在手机渠道上安全、快捷的办理金融业务。　　本产品分普通版和注册版,普通版可下载本产品自行注册开通;专业版可携带梅花借记卡或存折、手机至我行任一网点办理,享受更全面的功能体验。　　产品特色:　　1.随身使用　　您只需随身携带可以上网的手机,便可随时随地轻松办理银行业务,体验“一机在手,银行尽在掌握”。　　2.安全可靠　　通过绑定IMEI号、密码验证、SSL通讯加密,多重防火墙保护等多种方式保障您的资金安全。　　3.功能强大　　涵盖大部分的个人银行业务,并且在不断的丰富以及创新。　　4.方便快捷　　7×24全天候服务,超越时空限制,轻松省时;同城异地汇款,资金到账迅速及时。　　功能介绍:　　本手机银行包含账户管理、转账汇款、信用卡管理、基金代销、证券交易、理财产品认购、贷款管理、生活缴费、系统设置九大功能,同时还为用户提供我行网点、合作商铺的地址查询,并送上金融信息查询、金融小助手等贴心服务。
上海银行	上海银行全新推出个人手机银行，汇聚众多新颖实用功能，无论您使用任何品牌通信运营商网络或WIFI网络都可轻松使用。
优顾炒股	　　1、高仿真模拟交易：年轻人零门槛练习炒股票，不会有任何亏损风险。
Timi记账	　　Timi时光记账app是她理财团队推出的一款很火的手机记账应用，主打时光记账，以时间轴、快拍记账为特色，强调支出控制，Timi力求简洁可心，让记账变得更有趣。
记米宝	　　亲们是不是还在苦苦寻找一款小巧简洁好用的个人薪资记账APP?现在,她来了。
网格网络币	　　网格网络币交易软件算是一款区块链交易平台挖矿+趣步模式结合的交易平台，
爱心帮扶	爱心帮扶LOV正在空投，注册并通过实名认证，获得矿机一台，邀请补，社群补，等级制度达人团队化推广!
卡牛信用卡管家	　　【多重保障】　　大品牌打造，用户数据安全有保障；　　支持狠到位，随手网服务有口皆碑；　　数据非实名，用户与数据无任何关联；
光大金阳光	　　金阳光移动证券是光大证券为客户鼎力打造的全新一代移动证券平台，为客户提供专业的证券行情、交易、资讯服务。金阳光移动证券采用多项业内领先技术，使行情更快捷、交易更安全、资讯更及时，为客户提供全方位的专业证券服务。
艾米	　　艾米APP是一款集聚社交动态、电子商务、短视频、自媒体、悬赏任务、分红股为一体的综合性平台。
快摇吧	　　摇红包神器
e赚	　　良好的用户体验凭其特点快速聚拢用户
华融e银	　　（1）无地域限制：电子账户轻松开，跨行绑卡随地用
钱鹿	　　＂钱鹿＂，是一个崭新的移动APP的实用平台，
荷马国际证券	相关新闻
步步来金	　　步步来金app，是一款倡导运动、绿色生活、提升大众运动乐趣的app，
发发学堂	软件介绍
uu集步宝	　　uu集步宝app是一款超级火爆的走路赚钱软件，uu集步宝app只需要通过走路就能获取收益，并且uu集步宝app可以自动运行，不需要做任何东西，你每走的一部都能产生价值，每天签到还能获得红包奖励，让你的步数兑换金币，金币兑现！
旅途人生	　　旅途人生红包版是一个视频+区块链的模式，不是传统的合成模式哦，旅途人生红包版通过看视频的方式来增加年龄，年龄又可以生产成长值积分，积分可以买卖、赠送，也可以兑换分红，玩法新颖有趣，喜欢就下载旅途人生app体验吧。
奇乐短视频	　　奇乐短视频app是最近大家都在玩的一款短视频社交软件，在奇乐短视频app这里可以观看非常多的精彩短视频内容，奇乐短视频app可以边看视频边赚金币，收益很不错，边玩还能边赚，自己也能发布短视频内容，有多重的收益方式，奇乐短视频给大家带来简单轻松的赚金币项目，随时操作，打开手机看视频，喜欢的朋友欢迎来下载哦。
众源圈	　　众源圈app是一款类似于脉圈的广告赚钱平台。众源圈app的玩法和板块设计方面都很相似，目前刚上线期间，除了特殊广告位，众源圈app其他的广告都是可以免费发布的，并且众源圈app的认证成功还送1.5ZYT平台币，更多奖励，等你下载注册众源圈app体验吧。
比特界	　　比特界app是一款比较典型的币圈资讯平台，比特界app同时融入了区块链赚钱项目，每天流量新闻，做做任务就等于是在挖矿了，比特界还有完善的推广制度和交易制度，人人都可以参与，比特界APP，据传比特矿工联盟发起的，具有推广和扩散收益！
EB趣智慧	　　EB趣智慧app是一款和网赚资源相结合的区块链赚钱软件。大家能快速的实名认证，能参与EB趣智慧app星际达人的认证，EB趣智慧还能兑换矿机，能玩转种树的游戏，得到趣果的收益，趣智慧非常的多元化，任务超多，收入可观就在趣果世界app！
通联钱包	　　通联钱包app是通联支付旗下的移动支付产品，
奇点交易所	　　奇点交易所app是一款很安全的数字货币交易平台。这个奇点交易所平台上有多种数字货币，里面给大家带来了最新的数字货币资讯，同时奇点交易所app的这些数字货币都支持在线交易，每笔交易都有平台进行安全防护，这个奇点交易所平台非常靠谱，操作简单，能让你轻松的赚零花钱。
最强消消消	　　最强消消消红包版是一款可以赚钱的消除游戏，最强消消消红包版采用了经典的三消玩法，最强消消消红包版玩家可以获得更高的分数获得更多的红包奖励，最强消消消红包版随时都可以提现到账哦！
中融基金	　　中融基金APP，全新上线，
好股票	好股票app里有众多资深投资顾问、权威财经专家为投资者提供个性观点、解读重大财经新闻，洞悉市场热点涉猎的热门板块及股票投资契机。内容专业权威，数据精细挖掘，全面支持用户根据自主喜好与投资风格选择专栏体验与订阅服务。
金黔理财	金黔理财app是中黔金交官方唯一移动互联网理财平台，让投资者能够随时随地享受优质资产证券化开启的互联网理财时代，让您的财富更安全、便捷的增值。
好买基金	　　好买基金app是一款基金服务手机软件，这里汇集了丰富的基金产品，支持产品自由组合，定期活期应有尽有，支持在线交易，资金详情一目了然。好买财富专业投研团队生根基金行业，专业研究基金，对产品进行长期跟踪，为您提供专业投资建议。
汇金谷浙商证券	　　汇金谷是浙商证券为客户提供全方位专业便捷的金融服务神器。行情交易极速安全、理财产品一键购买、重大信息实时推送、投资顾问坐镇解，更为您提供融资融券、新股申购、开户转户等全方位的服务，是专业投资者的正确选择。
支付通QPOS	　　1、支付通Qpos页面全新改版，以悦动的橙色为主色调，在满足商户收款需求的同时、又重磅推出金融理财服务，带给商户不一样的收款体验。　　2、支付通Qpos金融理财产品是由金融、法律和电子商务等领域专业人才团队量身打造并经国有担保公司担保，为支付通Qpos商户提供更高收益、更高安全、更高灵活的理财产品　　3、支付通Qpos为商户提供收款服务的同时，解决商户在经营时不便办理银行卡转账，信用卡还款、手机充值等业务的燃眉之急。同时也为商户店面无成本投入下增加客流量，提高店面销售额。
华泰证券涨乐财富通	　　以“乐享智能”为主题的华泰证券涨乐财富通APP5.0发布会在南京举行。在人工智能浪潮下，如何为客户提供更便捷、更简单的理财服务工具，成为国内券商共同面临的课题，目前来看，华泰证券成为了首批交出答卷的券商之一。
省点饭店买单结账助手	软件特色
中金财富	　　中金财富app是一款有关投资赚钱的应用软件，中金财富app这里汇集了海量优质投资项目赚钱资源，有了中金财富这款软件，用户就可以更加方便的去所说的查看那些投资项目，在中金财富app这里，用户不仅可以学习到不少的有关投资赚钱的知识，还可以查看自己的收益。
极简速汇	极简速汇app是「极简汇率」旗下产品，是一款面向海外华人提供小额汇款回国服务的 App。帮助海外华人将汇款回国的成本、流程和时间压缩 80% 以上。
安POS	　　安POS APP是一款全方位移动收款助手，集刷卡、快捷支付、微信、支付宝、云闪付、银联二维码等多种支付方式于一机，为广大商户提供“安全、可靠、简单、便捷”的一站式移动收款服务。是国内领先的移动支付、智慧营销和创新金融的综合性收款终端。
令牌	　　令牌app是一款手机区块链赚钱软件，用户可以在平台上看到各种相关的区块链信息，每天都会实时更新区块链的最新消息，让用户每天都可以看到最新的市场消息，还有各种币种的交易行情，所有的数据全部连接交易所，让你可以轻松查看各种交易行情，用户也可以在平台完成各种币种的数字交易，平台有数字钱包加密功能，用户可以放心使用。
中泰国际环球易	功能介绍
勒沛影视	
资产星球	　　资产星球Dapp是基于“链斯达克”共创链的一款信用卡账单管理应用，资产星球app可让用户在信用管理、信用提升、信用应用等正面行为而获得实体通证化的积分，这些积分可以有各种兑换价值，以此来鼓励用户养成良好的信用习惯。
51收款宝	　　51收款宝app是一款基于移动支付的商户端移动收款软件，安装在收银员、店主的手机上，手机秒变无线pos机，结账时只需要输入收款金额，点击收款，系统自动打开摄像头，扫描顾客手机上的付款码，两秒钟完成收款，一切就是这么简单！
工商银行信用卡	　　工商银行信用卡app是一款中国工商银行信用卡官方客户端。工商银行信用卡app全新升级的2.0版本集生活、消费和金融服务于一体，是整合支付、融资、丰富生活消费场景的综合化移动智能服务平台。无论您是否是工商银行持卡人，都可享受工商银行信用卡app的便捷服务。工商银行信用卡app四大功能频道，汇集丰富的用卡及生活场景，让金融触手可及。
淘一卡管家	功能介绍
银河期货期权	　　银河期货汇点股票期权交易系统手机版（只适用于安卓系统手机），该软件可免费查看上证50合约的行情信息，银河期货有限公司股票期权客户还可登录该软件进行股票期权交易。
币响	功能介绍
苏E付	更新日志
金猫管家	软件特色
基金决策宝	　　【资质说明】由券商投研团队和国内外量化团队人员共同打造。
达州银行	　　达州银行app是一个为智能手机和移动终端用户量身打造的移动金融服务平台，达州银行app创建“常用功能”、“个人银行”、“我的惠银”、“更多服务”等金融服务专区，为您提供丰富实用的金融服务。
佳乾财富	　　佳乾财富，是浙江博佳投资管理有限公司旗下的互联网金融服务平台，为投资人提供安全便捷的互联网金融理财服务。　　佳乾财富核心管理团队由金融、银行、法律、互联网领域的专业人士构成，凭借十多年金融行业经历，将互联网思维、金融产品更深度联结，去除中间环节，打通通道，产生聚合，让广大用户能够投资国内优质产品。
金龟理财	　　1.双11活动：精品爆款，签到红包领不停　　2.新手有礼：8888元体验金、12.88%超高收益、6000元本金券　　3.首投惊喜：15天新手标，专享8.8%惊喜收益　　4.邀请好友：N次百分百中抽奖机会；好友首投5%收益返现　　【平台优势】　　1.合规：银行存管正式签订，风险准备金、质保服务专款陆续上线　　2.组合：多款期限产品和爆款活动，随心获利　　3.稳健：量化分散投资，创新四重风控保障，投资更可靠　　4.安全：银行级加密数据传输技术，更强的账户资金保障　　5.简单：5秒快速注册，闪电投资，快速起息，提现T+0
普惠通	　　普惠通app是一款普惠金融一网通应用App，普惠通app旨在为用户提供普惠授信、账户管家、金融超市等一系列信息技术服务，利用普惠通app可协助用户在线申请“普惠授信”等产品，普惠通app致力于为农民、小镇居民、个体工商户等弱势群体提供相关服务的移动信息服务产品。
理财云	　　新手注册送666元红包+16.88%高至收益
亿联银行	　　亿联银行定位为“以客户为中心，以科技为驱动、发展普惠金融为宗旨”的智能网络银行，通过大数据、人工智能、云计算等科技技术，在“衣食住行用”等各种场景中移动互联各个平台，为广大个人消费者和小微企业主、小微企业提供存款、贷款、理财、汇兑等金融服务。
金色财经	　　金色财经作为一款垂直性区块链新闻资讯 App，区块链创业者必备，让用户准确及时获取想要的头条新闻资讯，涵盖区块链、数字货币新闻资讯，实时数字货币行情走势，我们追求及时、全面、专业、精确的资讯与数据，致力于为区块链创业者以及数字货币投资者提供最好的产品和服务。
逗赚	　　逗赚app，一个趣味的兼职赚钱平台，边看电影边赚钱!带领全民掀起轻松赚热潮!随时随地，只需要通过一部手机操作聊赚，轻松做到想赚就赚，后期将不断更新更多劲爆功能!
打新小精灵	
中金国泰	　　中金国泰理财网是上海中金国泰金融信息服务有限公司旗下互联网金融平台，位于上海金融中心陆家嘴，注册资金1个亿。
支付宝企业版	　　支付宝的服务越来越深入到传统行业中，而这些行业的企业财务管理和资金结算的方式、要求和习惯，与个人或小企业有很大的差异。普通版、面向个人的支付宝网站服务，日渐不能适应这些企业的使用要求，而且容易带来企业资金管理风险。
招行小白卡	　　小白信用是京东金融消费金融业务的重要组成部分，目前与银行合作推出“小白卡”已呈规模化和常态化。
金阳光证券卓越版	功能介绍
港版支付宝	　　支付宝宣布推出香港版电子钱包DD支付宝HK，据悉，这是支付宝第一次发布境外版App。
好人好股	　　行情速度：一秒钟可达5次；
东莞银行直销银行	　　东莞银行直销银行app是本行为客户精心打造的移动金融服务平台。东莞银行直销银行app不仅为您提供传统的财富与投资理财服务，还为您提供装修贷、车位贷等普惠金融线上贷款服务，线上操作、线上审批、分期还款，致力于做您身边的银行。
VIP账本管家	软件介绍
乐学宝赚钱	　　乐学宝，作为“教育招生助手，机构专业帮手”，让教育机构的互联网升级变得更简单、更有效，针对性更强，成本更低。被誉为“一个神奇的招生工具”。
记账吧	记账吧app是一款轻便，简洁还会让你赚钱的记账理财好帮手。记账吧app帮你记录每一笔消费，做到心中有数，月月有余。用了记账吧app这款记账软件，再也不担心钱花哪儿了，还能真真实实的赚钱！日前超千万用户都在使用这款超棒的软件！
客商数字银行	客商数字银行app是梅州客商银行旗下的数字银行，面向线上互联网客户，支持用户在线开通II类账户，实现绑卡、充值提现功能，购买存款、理财等金融产品，以及提供抽奖、积分、红包等营销活动，满足用户多元化、个性化金融需求，让智慧金融服务触手可得。
蛋多多	　　蛋多多app是一款利用零碎时间养小鸡的休闲软件。
走走赚钱	　　走走赚钱app是一款以计步为主要功能，为用户提供基于步数相关的健康参数的App。鼓励主张绿色、低碳的生活方式，让走路的每一步都变得有意义。
计步宝	　　计步宝app是超级好用的一款运动赚钱软件，在这里您每天进行走路运动是会获得金币奖励。“计步宝”APP可以帮助到更多网赚爱好者，利用在线运动的方式，让大家把每天的走路、散步步数兑换为现金收益。每天都会发布各个等级的走路任务，走的越多赚的越多，还能签到打卡，喜欢的小伙伴们赶快点击下载吧！
全民呱呱	　　相信不少的人买过两元的刮刮卡吧，运气好的可能两元让你中几百甚至更多，运气不好就只能自认倒霉了，全民呱呱app这款应用和刮刮卡有同样的效果，但是全民呱呱app里是不用你花钱的，只需要做任务去领取金币即可，比如喝水即可做任务，还可以选择里面提供的其他任务，领取到的金币就可以买刮刮卡了。全民呱呱软件中用户们可以刮出各种各样的精美礼品，幸运的用户最高可以刮出1888元现金红包，感兴趣的你还在等什么？赶紧下载全民呱呱app使用吧
股先森	　　股先森是一款强有力的理财炒股软件，股先森为股民推荐切实可行的炒股策略和老师为大家推荐真实的投资经验。股先森从同花顺、大智慧、通达信、操盘手等同类理财炒股软件中脱颖而出，是具高潜力的炒股工具，炒股当然股先森！
划时空奖金版	　　划时空奖金版app是一款可以发布自己歌曲的手机软件，你的歌曲点击量越高，你的收益也会越高，在这里你不仅能够做这自己喜欢的事情，划时空奖金版app还可以展示最优秀的自己，感兴趣的小伙伴们不要错过了，赶紧来下载体验吧。
微众企业爱普	微众企业爱普app是腾讯牵头发起设立的国内首家互联网银行，持有银行牌照。微众企业爱普app为小微企业主提供账户查询、转账支付、银企对账、业务咨询等金融服务，让小微企业直通银行。
发发问股	　　发发问股app是一个既可以提问也可以赚钱的理财平台，发发问股app为广大股民朋友们提供实用的股票资讯服务，在发发问股app内有专家在线直播讲解，还可以参与话题讨论，好股分享等等，发发问股app是广大股民朋友们必不可少的炒股助手之一。
炒牛股	　　炒牛股app是一款炒股必备的APP，找牛股抓涨停，一个APP全部解决，炒牛股app有着极速行情，要闻推送，实时跳动的毫秒级行情信息，带你随时查看股票走势分析，炒牛股app让你随时掌握市场动态。
趣打字	　　趣打字，一边打字一边赚钱的输入法！
安收宝	　　快钱安收宝是一款刷卡软件，可以轻松进行卡刷服务，以商家收款为特色，随时随地方便进行收款，让大家刷卡更加的轻松方便！快钱安收宝集成各银行,专业资格的第三方支付清算机构通道，为商家提供最便捷的收银软件，支付宝二维码，微信二维码，银联二维码，百度钱包，qq钱包。京东钱包二维码，翼支付二维码！
慧投资	　　慧投资APP，是中国证监会批准的证券投资咨询机构DD上海新汇通投资顾问有限公司（许可证号：ZX0023）旗下品牌。公司汇聚多位知名投资顾问，如王健（长期受邀担任第 一财经嘉宾）等，更有10多位资深投顾组成的时金研究所团队，为广大投资者朋友提供专业高效的投资知识服务。
宝贝支付	“支付”诞生在阿里巴巴张江创新中心，拥有强大的技术背景做支撑，产品上线已获得百万用户的青睐！
股拍	　　股拍app专业的证券视频社区，股拍app让您可以利用碎片化时间，随时随地快速洞悉市场热点，股拍app把握投资先机，轻松玩转股市。
有信征信	有信征信app是权威在线实时征信报告查询工具，对接全国主流的风控征信中心、信用检测机构，让用户能够实时查询征信情况，与中国人民银行征信中心所得报告互为补充，及时得知个人不良信用记录，信用问题原因一目了然。
将军财富	　　将军财富，一款专为广大股民打造的大数据智能选股APP。
容维财经	　　一款强有力的理财炒股软件
ETF组合宝	　　etf组合宝手机版是一款专业的理财平台，ETF组合宝app提供了丰富的理财技巧，用户通过ETF组合宝app可在线学习快速成为理财大神，ETF组合宝app支持在线交易，超多奖励不断更新，免费拿提现到账速度快，欢迎免费下载ETF组合宝app使用体验。
海豚股票	海豚股票，科技创造财富！
将军财经	　　将军财经app为广大股民打造的一款大数据智能选股APP。将军财经app拥有专业知识与庞大团队的将军研究院，投顾老师每日分析股票行情，选股、跟踪庄家资金流向，致力于为广大股民提供专业、透明、高效的股票投顾服务。
京东数科	　　京东数科安卓版是一款在手机上可以让你轻轻松松投资赚钱的软件。近日京东金融的官方微博悄悄的更了名，京东金融变成京东数科。意味着除了在此之前的金融业务外，京东金融还将涉及到数字科技行业，将整个实体经济数字化。
同花顺期货通	　　1．传承同花顺技术优势，稳定可靠。
华赢海马	　　华赢海马app是一家互联网金融公司。我们始终相信，华赢海马app的客户值得拥有更便捷更可靠的投资理财方式，华赢海马app利用先进的互联网技术为投资者提供更快捷的券商服务。在为投资者保驾护航的同时，华赢证券努力打造成为一个“经营规范。结构完善、管理科学、风控严格”的金融投资平台
快记账	　　史上最适合年轻人的记账app!功能全面内存小，界面清新启动快，为你省钱省力省时间！提供快速方便的一键记账功能，清晰明了的消费支出报表，更包含记账闹钟、购物清单、云端同步等实用功能，陪伴每一个认真对待生活的你！
天下信用	　　天下信用app是一款综合企业信用查询报告，个人信用查询报告，征信授权，个人信用查询评分，失信举报，财富测评，工资预测，信用卡申请、生活服务等一体化移动互联网征信服务平台。天下信用app集合了鹏元征信14年征信查询数据资源、技术资源、服务经验、服务渠道等优势，是“移动互联网 征信”的完美呈现。
金魔仆	　　1、优选基金，智能决策(金智帮您搜集全面的行业大数据)
来客坊	　　来客坊app是一款专业的房产服务平台。来客坊app之前主要是从事酒店民宿运营，现在转型做区块链啦，新用户注册下载来客坊app就送一个新手任务包，每天签到就能领取来客券，来客坊app既可以用于订房，又可以交易变现，感兴趣就下载来客坊app体验一下项目玩法吧。
广发易淘金	　　广发证券易淘金从华泰证券、海通证券、中信证券、平安证券、国泰君安等券商中脱颖而出，荣获“新浪财经2015年券商APP风云榜”第一名，总下载使用次数超过5000万次。
优配策略	　　在优配策略app，不管你想学习股票入门知识，还是炒股技巧、炒股绝招，炒股票高手就用优配策略！
联泰基金	　　联泰基金app是一款非常受欢迎的基金理财软件，联泰基金app提供基金开户，基金交易，账户查询等功能。还有每日资产明细，联泰基金app让你清楚了解每一笔收益，资产状况一目了然。联泰基金app致力向投资者提供权威、专业、及时、全面的理财服务，涵盖基金交易、金融资讯、理财行业动态、基金数据、基金评级、投资理财分析等内容。
东兴198	　　东兴198开启3.0智能炒股时代，快闪电下单、一键打新、先人一步 美 
优雅的UI设计、界面美观、大方体验流畅、开启移动互联网+券商创新新生代交互体验全开户、行情、交易、资讯、融资融券、理财、业务办理、金股在线(投顾产品)、实盘金股(投顾产品)、添迎利、兴e融、客服1对1智凝聚智能大数据技术的各种新功能，让你在股市如虎添翼 
数据决定价值，科技发现机会。
e百福商家	功能介绍
重庆农村商业银行	　　重庆农村商业银行app是重庆农村商业银行从传统银行到移动银行一次重大的飞跃与进步，重庆农商行客户端的成立标志着广大重庆农村商业银行的用户无需去银行排队就能在手机上实现查询账户、转账汇款等一系列服务，同时也提高了用户对于重庆农村商业银行的满意度。
2345王牌技术员联盟	　　作为全国领先、专业的电脑技术员联盟，2345王牌技术员联盟致力于成为让全国技术员设主页装软件终身领薪平台。
TIP专享	TIP专享app作为服务型软件，为用户提供更便捷的生活体验，并支持客户对在TIP专享app上对与我司的合作项目进行管理，实时查看项目的具体信息和进度以及反馈情况，为您打造尊享的用户体验。
中泰融易理财	　　中泰融易理财是中泰证券重点推出的集理财、服务、行情、业务办理功能于一体的新一代互联网金融APP，在实现查看股票行情、资讯的基础之上，我们隆重推出了7*24小时理财账户体系，您随时可以轻松开启您的快乐理财之旅，让您的资金在股市休市后也不“睡觉”，持续助您成就财富梦想。
京东白条闪付	　　白条闪付是京东金融与银行联名的电子银行账户，由银行完成对客户身份真实性核验及开户授权，白条闪付为拥有该账户的个人消费者提供消费贷款。通过京东金融的底层账户和风控技术实现了“白条”与银行账户的连接，让白条闪付能够线上实时开户、线下实时支付，移动端消费金融支付体验得以升级。
西安银行企业手机银行	功能介绍
天安金交所	　　天安金交所 ，全称“天安(贵州省)互联网金融资产交易中心股份有限公司”， 
2015年11月在贵州注册成立，由贵州省人民政府金融工作办公室备案审批成立，注册资金1亿元，100元起投，预期年化收益5.8~7.3%，本金及预期收益由天安财险提供履约保证保险。在国际金融中心上海陆家嘴和互联网大数据产业中心贵阳设立双总部。
天洛爱分享	　　天洛爱分享软件是一款全新上线的分享文章、视频就能轻松赚钱的app平台。这款天洛爱分享app拥有比较完善的奖励体系，所有天洛爱分享的任务都能在完成之后分分钟获取收益，提现0门槛，是大家都非常喜欢的线上学习平台，天洛爱分享软件并不需要任何的基础就能快速完成，每个任务的单价也比较高，每天赚到的钱都能轻松提现！
铁岭银行手机银行	　　铁岭银行手机银行是为安卓手机客户量身定做的手机银行渠道服务，无论您是否持有铁岭银行的银行卡，都能享受铁岭银行提供的稳定、贴心、细致的金融服务。“便捷转账、无卡取款、水电取暖费自助缴纳、交通违章查询缴纳”等强大功能以及7*24小时全天候免费服务，让您尽享铁岭银行手机银行移动新生活。
中邮通达信	　　中邮证券有限责任公司，2002年9月经中国证券监督管理委员会批准设立，注册资本20.6亿元人民币。中邮证券是中国邮政集团公司绝对控股的证券类金融子公司。
爽爽bank	　　爽爽bank是贵阳银行专门为智能手机和移动终端客户打造的移动金融服务平台，爽爽bank为您提供超级转账、余额查询、个人账户管理、交易记录查询等诸多金融服务，满足您的移动金融需求。爽爽bank界面方便简洁、可自定义自己喜爱的功能服务。爽爽bank高度集成了直销银行功能，直销银行用户专为非贵阳客户量身打造，方便客户进行理财交易。
海峡银行	　　（一）易用便捷
财通证卷	　　财通证券是财通证券自主研发的移动端一站式理财平台。财通证券股票不仅仅是一款手机炒股软件，还提供了各种理财咨询服务。行情交易极速安全、重大信息实时推送、理财产品一键购买，一站式服务尽在掌握。财通证券软件是您随身的证券助手，帮助您指点间把握稍纵即逝的投资机会。
万达普惠	　　万达普惠app是一款非常好用的手机借贷软件，万达普惠app大品牌，放心贷。我们致力于为用户解决急需用钱的问题，所以我们的借贷最为便捷用户，无需抵押，贷款申请秒通过，最快*3分钟下放贷款，帮助大家快速申请低息借贷，解决你的所有借钱难问题，解决你的后顾之忧。
银行业统一支付	　　中国银联推出银行业统一APP（云闪付）。云闪付APP是各银行和中国银联共建的移动支付统一服务入口，将各大银行卡集为一体，在线充值缴费、转账汇款、充值等方便快捷，支持线上线下全生态移动支付，覆盖日常生活的重要支付场景，提供全面的银行卡跨行账户特色服务。
小龙理财	v5.4.1.0新版 5.0.4.0
鲸准	　　鲸准数据是国内领先的一级市场数据库，收录国内一级市场更新更全的投融资数据。现已收录和维护一二级市场、TMT以及非TMT项目在内共50多万个项目，同时平台入驻6000+家投资机构及10000+投资人。
山东金交所	　　山东金交所app是山东金融资产交易中心官方推出的手机客户端，提供丰富的金融理财产品的资金交易动态，让投资的朋友拥有更好的服务，由山东金交所官方指定的会员使用，本软件推动了济南区域金融中心建设，进一步完善了金融要素市场。
泸州银行	功能介绍
支付宝企业版	　　支付宝的服务越来越深入到传统行业中，而这些行业的企业财务管理和资金结算的方式、要求和习惯，与个人或小企业有很大的差异。普通版、面向个人的支付宝网站服务，日渐不能适应这些企业的使用要求，而且容易带来企业资金管理风险。
汇正财经	　　1.真牛客，真盈利
富民银行	　　富民银行是一款针对重庆市民打造的富民银行手机客户端，支持多种银行在线预约办理，手机支付转账汇款缴费等，轻松畅享手机银行生活。
浙江稠州商业银行	基本简介
银河证券海王星	　　中国银河证券海王星app提供多界面自由切换、多种登陆模式；银河证券海王星手机版操作简便快捷，功能强大齐全、速度快、业务并发处理能力强。
每日付	　　每日付是杭州微盘专为安卓手机用户推出的银行卡通道收款软件，具有多种通道收款、查账、收款数据分析、会员营销及卡券营销等功能，方便商户收款及营销，让商户收款更加高效便捷。
渣打银行	软件特色
方小期	　　方小期手机交易客户端，是方正中期期货有限公司联合上海彭博财经推出的，为期货投资客户提供网上开户、网上行情、期货委托交易、银期转账、期货金融资讯等服务于一体的期货网上交易手机软件。软件具有首页、自选、行情、交易、我等五大板块。
Tiger Trade	　　DDD为什么选择 Tiger TradeDDD
格上财富	　　格上财富app，专业的第三方财富管理机构，获证监会颁发的私募管理人牌照，拥有强大的研究以及风控能力，8年来深度走访调研，精选阳光私募、信托、PE等高端理财产品，为您量身定制资产配置方案，规避投资风险，是您投资理财的明智之选。
四川农村信用社	　　四川农村信用社手机银行客户端是专为四川农信用户打造的移动服务APP，方便客户更便捷使用手机银行，是将金融及生活等多种服务与手机相结合推出的移动电子银行产品，为客户提供7×24小时的现代金融服务。
广东农信社	　　广东农村信用社客户端是一款专为广东农村信用社用户打造的手机客户端，客户端安全有保障，帮助用户轻松管理自己的银行账户。手机绑定，动态密码操作，给用户带来最便捷的操作。
平安走步	功能介绍
信用付	　　信用付是一款集消费分期、信用卡代还、零钱理财和商家o2o精准营销于一身的信贷理财应用，结合消费金融+互联网行业生态，利用大数据风控，估算用户的信用评分，拟定信用额度。
四川农村商业银行	　　四川农村商业银行手机银行客户端是四川省农村信用社为个人客户量身打造的手机银行服务平台，可让您随时随地享用银行服务，如余额查询、交易明细查询、行内转账、跨行转账、手机充值等。此外， 简洁流畅的UI设计，为您提供优良的使用体验。我行手机银行采用了多重密码保护机制, 加以手机动态密码多重认证, 保障您的交易资金安全。
余月宝1号	　　1、余额宝背后是货币型基金。
萝卜投研	　　萝卜投研(robo.tt)-----基于大数据和机器学习的智能投研平台。利用人工智能、大数据、移动应用技术，建立开放、分享、高效的基本面投研平台，满足用户在证券研究过程中高效处理信息、快速挖掘投资线索迫切需求。同时使得碎片化的研究成果得以沉淀积累，构建投研核心竞争力，为投资决策提供重要支持。
支付宝发票管家	　　生意兴隆的支付宝日前又引入了新功能DD发票管家。
五矿手机证券	平台介绍
熊猫记账	熊猫记账app是一款采用卡片式风格纯记账软件，功能丰富实用，日账、周账、月账、年账，一应俱全，还有简洁实用的饼状图报表等，并实现了自动账单同步到云端，即使换了手机也能轻松的同步账单数据，超级简单实用，熊猫记账，生活记账一个搞定！
头号理财	头号理财app是联泰基金倾力打造的理财服务平台，具有证监会核准的基金销售资质，头号理财app平台所有产品由已建立代销合作的130+公募基金、券商等持牌金融机构提供。
众帮网赚	　　众帮网赚app是一款非常不错的手机兼职悬赏任务理财软件。众帮网赚这里每天都会更新大量的悬赏任务资源！并且各种类型的都有哦！大家可以轻松的来众帮网赚app这里进行一个操作，获得自己需要的收益。每天都能打开手机随时的进行关注，找到自己需要的悬赏任务来进行完成，超级的靠谱省心哦！一应俱全的服务板块都是可以带给大家的。
赚钱小项目	赚钱小项目是为大家分享的一款做任务赚钱的手机软件，每天推荐优质的赚钱项目，用户可以通过打字、看新闻、走路、发悬赏任务轻松赚收益，一元即可提现，没有任何手续费用，需要的朋友欢迎下载体验吧。
期货进阶宝	
财务专家	　　无论您是企业老板，财务员工，部门负责等，无需任何会计知识，轻松管好每一分钱
柠檬喝水	　　柠檬喝水app是一款最近刚上线不久的手机赚钱软件，通过最简单的喝水方式，全民参与的赚钱项目。这款软件采用的最新的技术能力，通过统计大家每天的喝水情况让用户们获得长期稳定的收益。是一款一举两得的线上软件，一边可以帮助您养成良好的生活习惯，另一方面还有很多的零花钱可以赚取。全家人每天坚持打开使用，收益就是成倍的增长哦。
中国网赚联盟	　　中国网赚联盟app提供最新免费网赚项目,网赚兼职及网上最靠谱赚钱的方法;
金鼠引流	　　金鼠引流app是一个免费推广引流，金鼠引流还能做任务赚钱的平台，在这里是可以免费发布广告的，并且还有悬赏板块可以接任务做，金鼠引流平台还开设了超高的推广奖励，人脉广的小伙伴进行适当的推广，也能获得不错的收益。感兴趣话一定要进行尝试。
湖南三湘银行	　　湖南三湘银行app是湖南三湘银行为客户量身定制的移动金融服务平台。您只需将三湘银行账户与手机号码绑定，就能让手机成为您的金融贴身管家，随时随地为您提供智能、贴心、便捷的移动金融服务，三湘银行，立志于让银行成为一种随时可得的服务。
裕民银行	　　江西裕民银行app全新上线，新服务、新体验，为你而来。
步行宝	　　步行宝DD一款为您准确记录每日运动走路步数的APP。
微众企业爱普	微众企业爱普app是腾讯牵头发起设立的国内首家互联网银行，持有银行牌照。微众企业爱普app为小微企业主提供账户查询、转账支付、银企对账、业务咨询等金融服务，让小微企业直通银行。
极速短视频	　　极速短视频app是一款更为好用的短视频分享兼职平台，极速短视频app能提供更为精彩的短视频内容去分享查看，直接分享到多个不同的社交圈中即可，每一次的分享都是有奖励的，所以会给大家带来更为独特的兼职新方式，全新的短视频都能在这里浏览，比较的方便！
惠支付商户版	　　惠支付商户版是四川农信为特约商户量身打造的一款通用的支付收单工具。
天星金融	　　小米天星金融app由小米官方推出的手机在线金融服务平台，天星金融主要是为各位用户提供理财、保险、借贷等等方面的服务。在这里，可以帮你解决关于“钱”的问题。天星金融旨在为米粉和用户提供安全、快捷、方便的金融科技服务，并致力于成为全球米粉和新制造业的全面金融伙伴。
白马财经	常见问题
这厮有礼	　　这厮有礼是一款在线调研类APP，用户可以参与在线调查并获得奖励。用户接取任务完成任务既可以获取奖励，单价高，提现迅速
睿投科技	　　睿投科技app是针对短视频设计的辅助软件，睿投科技软件的功能十分强大，可以给用户批量进行视频点赞，让用户能够快速获得点赞数量的任务，有了睿投科技app用户会释放双手，自动为短视频点赞。各大主播平台发布作品以及对用户的抢夺需要点击率、点赞率！而睿投科技这一自主研发的手自一体、及时切换IP点赞机器人应运而生，睿投科技平台合作对象包括短视频、快手、火山、西瓜视频、微视等短视频自媒体平台。睿投科技app为以上合作对象提供网红推广视频自动点赞平台，发布任务，睿投科技软件招募点赞能手，从中赚取佣金差价。
欢乐赚赚赚	　　欢乐赚赚赚app欢乐赚赚赚app是一款休闲赚钱软件，走路赚钱、运动赚钱、阅读赚钱等多种赚钱活动在这里都可以找到，帮助用户进行赚钱打造.走路赚钱、运动赚钱、刮卡赚钱、种水果赚钱、看文章赚钱、早起赚钱、购物赚钱，玩手机就能轻松赚零钱！欢乐赚一款专门为用户打造的网赚APP，你的第二份工资就在欢乐赚！
多尚记账	软件介绍
优旺科技	　　优旺科技抢单平台十分靠谱，优旺科技app是一款值得用户来入手的手机自动抢单赚钱的软件，上面每天的任务多的做不完，每天都有新的商家入驻下单，任务做起来特别简单，单价也是全网范围内十分的高。
字节传媒	　　字节传媒app里面的点赞任务很多，而且会不断的更新，大家不用担心没有任务做。主要是抖音作品点赞、关注和分享，每天利用自己空闲的时间就能够赚到点收益，还是很不错的，至少零花钱还是可以保证的。所有的用户都需要账号登录进来，新用户直接手机号注册，然后绑定自己的账户，方便之后进行提现。
今融道	今融道APP是一款以北京金融街、上海陆家嘴、深圳福田中心、香港中环为核心发起的金融连接平台，今融道APP秉承共享金融，分享价值的用户理念，精准匹配金融问答、金融资讯、项目平台、金融招聘、圈层社交、数据研究等多维度的金融信息服务。
CBCF	CBCF，正在空投，免费注册并通过认证，获得矿机一台，邀请补，等级制度，团队化推广!
ACH信息币	ACH信息链正在空投，注册并通过认证，获得矿机二台，推广扩散激励烧，团补，星级达人式制度，团队化推广！
恒生个人理财	　　私人银行
富途牛牛	　　【三大行情】A股、港股、美股行情，一网打尽
优米宝	功能介绍
松树赚	　　松树赚app是一款最新上线，还热乎着的手机任务赚钱平台。大家在松树赚钱app这里可以获得很多不同的赚钱任务，收益都是杠杠的，另外松树赚app只需要简单地通过完成任务就可以获得对应的奖励啦，不同职业只要你有空闲的时间都可以参与进来，轻轻松松一个月的零花钱就可以赚出来啦，新人注册还赠送超多的现金奖励，加入进来不要犹豫啦。
工银融e联	　　近日，工商银行携手中国联通推出专属手机卡DD工行e卡。该卡推出超值套餐，为广大用户提供多样增值服务。
宁波银行直销银行	　　直销银行 描述　　宁波银行旗下直销银行投融资平台官方APP，在业界领先的风控体系保障下，结合全球金融发展和互联网技术创新，提供专业可信赖的创新型高收益投融资理财服务，为您获取更多更安全的收益，实现财富增值！
银河玖乐	　　玖乐是一款中国银河证券为你精心打造的安卓手机平台证券交易系统，玖乐android版集行情、交易、咨询、服务多种功能于一体，还优化了个股搜索处理机制，提升了个股信息显示效率，致力于为你带来快乐的理财之旅！　　银河“玖乐”主要特色功能：　　1.及时的多市场行情、资讯信息；　　2.稳定、安全、高效的多品种交易功能；　　3.实时的大势研判、盘中播报、个股研报、个股诊断等银河特色产品；　　4.图形与列表组合展示、关联快捷便利操作、具有与iPhone体验高度结合等特色操作优势；
DOGE狗狗币	　　广告汪，全球第一款狗狗币DOGE落地式应用项目
招商智远理财	更新日志
蓝狐接码	　　蓝狐接码app是一款全新的在线编码和赚钱平台。蓝狐接码软件内置的超级多任务资源，庞大的任务分类，用户可以直接自由地免费获得主页，并根据需要完成它们，从而快速赚钱，赚钱一路走来，轻松，稳定，蓝狐接码致力于为您带来一款软件，实现一路盈利!这款软件可以帮助用户们领取到各种的赚钱任务，丰富的任务根据自己情况自由挑选，完成任务就能获得可观的收入，每天只需要一点点时间就能轻松赚钱。
ourDeFi	　　ourDeFi app是一个全球化的去中心金融服务平台
BTCs挖矿	　　BTCs挖矿平台是通过矿机来进行收益的。而且用户每天在BTCs挖矿app上都是可以挖矿的，动动你的小手指就可以轻松的有收入，你想知道自己的收入在个人中心就能很快的看到。BTCs挖矿软件是非常方便的，第四季，BTCs挖矿即将开挖，抓紧注册抢先机！量不多
中本聪挖矿	　　中本聪挖矿app即将开挖，抓紧注册中本聪挖矿抢先机！
卡牛信用卡管家	　　【多重保障】　　大品牌打造，用户数据安全有保障；　　支持狠到位，随手网服务有口皆碑；　　数据非实名，用户与数据无任何关联；
中国银行	　　中国银行手机银行Android客户端软件是中国银行针对Android手机用户推出的手机银行服务，提供包括账户管理、转账汇款、投资理财、信用卡、账单缴付、电子支付等金融服务，以及优惠活动、网点查询、掌聚生活、自助注册、存贷款利率、外汇牌价、理财产品等多项增值服务，方便您随时、随地、随心地享用中国银行专业金融服务。　　本软件为免费下载软件，支持的固件版本为2.3或更高版本。
同花顺股票	　　同花顺(300033)手机炒股 股票软件是市场上行情交易最快、数据最全、支持券商最多、领先支持沪港通，最受股民欢迎的完全免费的炒股(金融/投资/理财/证券)软件。　　【炒股必备】　　最多券商：同行业中支持全国最多券商在线交易　　(如广发证券、东吴证券、方正证券、光大证券、国泰君安、银河证券、申银万国、中信证券等)　　闪电下单：分时快买快卖，投资下单快人一步　　新股申购：随时随地申购新股，收益一丝不落
ETHP以太原力	ETHP以太原力正在空投，注册并通过认证，领矿机三台，邀请补，邀请扩散收益，邀请扩散收益，阶梯团队收益，星级达人式制度，团队化推广！
财联社	　　财联社官方app全面监控全球证券市场资讯，财联社24小时滚动播报为投资者提供365天24小时不间断的电报快讯。财联社以“快速、准确、权威、专业”为准则，提供财经资讯、数据分析、专家咨询等全方位的金融信息服务，已成为机构和私募投资的首选工具。
国都交易宝	　　超低佣金：港股佣金仅万3，转户按原券商收费五折
伯乐创投	伯乐创投app是一个正规的创新型互联网天使投资推荐平台，伯乐创投app旨在发挥自身专业优势，帮助广大民众全民参与（类似于众筹），投到目前尚在萌芽期、但未来发展潜力巨大的互联网创业公司，小投入大回报、四两拨千斤，成人达己、合作共赢！
金十数据	　　金十数据手机版app是一款专业的财经资讯软件，金十数据手机版app提供全球最新行情资讯，金十数据手机版app满足不同人群需求，各项数据显示一目了然，原创编辑独家翻译带你解析新内容。
九银店老板	九银店老板app由九江银行官方出品，是一款集特约商户首款语音播报、交易查询、对账统计、店员管理、金融服务等为一体的金融服务平台，满足商户的各项服务要求。
一木记账	　　一木记账app简约而不简单的智能记账软件。通过自然语言处理算法，可从一句话识别出账单时间、分类详情、金额等关键信息，通过手动输入或语音输入等方式输入一句话可实现极速记账。
有鱼金服	　　有鱼金服是一个安全专业的互联网理财平台，专注打造优质基金投资体验。在有鱼金服手机版中用户可以享受一站式基金投资服务，全方位、多角度比较，选基更省心，实时取现，快速到帐。
港版支付宝	　　支付宝宣布推出香港版电子钱包DD支付宝HK，据悉，这是支付宝第一次发布境外版App。
余额宝	　　余额宝是支付宝推出的一项余额理财产品。您把资金转入余额宝，实际上是购买了一款由天弘基金提供的名为【余额宝】的货币基金（曾名为增利宝货币基金），可以随时转入、转出或消费；
赚钱用	功能介绍
二维火收银	　　二维火收银系统基于安卓系统研发、采用云计算架构、软硬件一体。
米赚	　　中国第一手机赚钱平台。米赚在2011年9月正式发布，是国内第一个专注于移动威客的手机应用，拥有500万用户，是国内最大的手机赚钱应用。
益盟加强版	功能介绍
掘金宝	　　掘金宝app是一款泛娱乐、体育资讯视频软件，掘金宝app可以让你时刻看到精选热门趣闻、视频及精彩图集，最新的新闻资讯，最大的影视库，资讯、影视想怎么看就怎么看，还可以赚车赚洋房哦！
萝卜股票	萝卜股票利用机器学习方法，深度挖掘"股市信息"与"用户个性化投资理念"的相关性，并与用户行为相结合，提供"用户画像、个股诊断、持仓诊断、大盘预测、智能盯盘、智能研报、智能选股"等智能化投资服务。
一直领	　　一直领app是一款动动手指即可轻松赚零花的手机兼职做任务赚钱软件。一直领这里每天都会更新大量任务，任务种类丰富，一直领app简单易做，每天赚钱更轻松，邀请好友还有佣金与分成，每天躺着也能赚收益，并且一单一结非常的nice！邀请好友加入还能获得更多红包奖励！
巴豆好赞	　　巴豆好赞app是一款线上看短视频赚零花钱的软件。我们的巴豆好赞平台内有多种多样的短视频，每天海量更新，你在观看的同时，随手点赞就能赚钱，巴豆好赞app是你的兼职好帮手，更是短视频爱好者的福利，一边看视频一边还可以赚钱，躺着就能积攒财富，为什么不选择呢。
今小闲	　　今小闲任务平台是一款用手机做任务、做兼职、看新闻与头条资讯的手机赚钱神器。你可以利用闲暇时间在线作业，获取兼职报酬。今小闲提供免费、简单的在线兼职任务，无论你是学生、白领，还是自由职业者，无论你在通勤路上，出差路上，还是闲暇午后，只要有网络，拿起电脑或手机，就可以在线做任务，通过今小闲获取额外财富。
火狐赞	　　火狐赞app是一款通过为短视频点赞，轻松获得收益的手机软件。火狐赞app里每日为你上新各种推广任务，你只需要按照要求为特定短视频点赞、评论即可完成任务，获得奖励金，在这个软件上每一天都会有超多新的网赚更新推出，你在有需要的时候直接的互动然后得到奖励。
国金交易宝	国金交易宝App，是由捷利港信软件（深圳）有限公司打造的，为您带来的股市掌上交易服务平台，港股行情实时知晓，交易便捷操作简单。
比特信息	BitMessage比特信息基于区块链技术的去中心化加密聊天软件，将区块链生态应用、加密货币及社区、社交资源的互通结合，打造区块链时代的社交生态价值共享平台，推出“人人贡献，人人受益”的社群价值体系，建立用户“流量”共识池，让每一位用户参与平台的建设和发展，共建BitMessage生态系统，实现区块链产业一个超级流量入口的全球化社群。
股航家	　　股航家app是民众证券的移动端一站式炒股平台，股航家app是专为广大股民打造的一款集股票开户、股票交易、股市行情为一体的股票/证券/炒股/理财/投资/财经/金融软件。
YChain悦链	YChain悦链正在空投，注册并通过认证，获得算力0.02T，每日手动领取，等级制度，多级长链收益，团队化推广！
Wind金融终端	　　Wind金融终端，数十万金融专业人士的选择，优质的中国金融业生产工具和平台
尺度	　　下载尺度app，加入财经知识分享社群，尺度app，与中国的投资者一起分享财经知识干货。
攀枝花商业银行	　　攀枝花商业银行手机银行app是一款来自攀枝花市商业银行针对移动终端推出的手机银行，攀枝花商业银行手机银行app手机银行充分利用了安卓系统的特点进行功能开发，设计新颖，流程简单，具有极佳客户体验。
项目工场	项目工场app是一个在线股权交易平台，由经验丰富的清科资本团队运营。项目工场app通过互联网化的股权交易平台，帮助企业及投资人降低资本运作门槛、减少交易环节、降低交易成本、提升交易成功率，让天下没有做不成的股权交易。
回收侠	基本简介
经传股事汇	功能介绍
梧桐诚选	功能介绍
有鱼基金	基本简介
益盟股票	基本简介
新客驾到	功能介绍
股管家	　　为用户提供7X24小时实时财经新闻资讯，做有深度的财经资讯，推有重磅的财经头条！
嘉善农商银行	功能介绍
云账本	软件介绍
国美黄金	　　国美黄金是多边金宝商业有限公司旗下的黄金金融业务品牌及产品名称，
泰达云	　　泰达云app是一款区块链软件，泰达云app是一款usdt场外亲自搬砖的应用，泰达云app里只要完成实名认证就可以启动交易，可以随时抢单买和寄售，非常方便，泰达云app就是一个赚差价的平台，自己想办法在各种货币之间进行转换，只要你可以研究出来，你就可以有无限的财富可以随时轻松的赚取，可以随时在线获取更多的收益，可以随时按照这里的规则来一步步的玩，邀请更多的用户加入这里，可以获取更多的佣金！
创易兼职	　　创易兼职APP是一个非常方便的兼职平台，为大家提供的海量兼职任务，随时都可以在这个平台上面选择自己感兴趣的任务。在这里面每一个兼职任务都是经过了严格的审核，而且每一个任务都有详细的介绍，选择合适的兼职岗位报名，将你感兴趣的形式收藏，在平台上面做完兼职之后，系统还会自动为大家统计收入。
68赚网	　　68赚网手机版，只需每天浏览广告、点击广告、悬赏任务，都可以轻松获得金币，兑换成现金，大家速度来做，赚零花钱，赚生活费，我每天花1小时做任务。
融托金融	　　1.移动理财、更省心！
68接单	　　68接单软件平台上所有上新的任务都经过人工检查，可以保证所有信息都是真实可靠
友金所	　　【认识友金所】 友金所由用友网络（股票代码：600588）、深圳力合金控与银行专家管理团队联合设立。作为用友集团成员企业，友金所致力于提供专业的全流程金融信息服务，打造安全、便捷、可信的综合性投融资平台，为投资客户提供安全、本息担保、收益稳健的互联网理财服务。 友金所作为专业的互联网金融P2P理财平台，收益高达15%，更有YY理财、友金e富等期限灵活理财产品，总有一款适合您。
金挚	　　金挚APP是金智东博（北京）教育科技有限公司引入权威银行专家团队和顶尖互联网团队，历时两年的调研和开发，针对金智用户的营销需求专属定制的营销策略神器。
深农商企业版	　　深圳农村商业银行专为您打造的企业手机银行客户端，为您的企业带来轻松便捷的移动金融体验。简单，更懂你!
微享任务	　　微享任务app是最新的做任务赚钱软件，
牛牛赚	　　牛牛赚app是一款最新上线的微信挂机赚钱APP，效率惊人享有非常可观挂机收益。
网商银行	软件特色
掌发宝	　　外出辛劳工作，担心什么？当然工资算错，公司发错！
温州银行	　　温州银行手机银行客户端（安卓版）是根据Android系统特点而开发的移动金融服务系统，利用手机为载体，通过手机上网登录客户端操作，作为一种崭新的电子银行服务渠道，更加突出了“随时随地、贴身快捷、方便时尚”的独特性，真正实现了“Whenever、Wherever（任何时间、任何地点）”的新型电子银行服务理念。
上海银行	上海银行全新推出个人手机银行，汇聚众多新颖实用功能，无论您使用任何品牌通信运营商网络或WIFI网络都可轻松使用。
东莞银行	　　在具备转账汇款、缴费支付、投资理财、账户管理、手机充值、网点地图、自助预约等常用功能的同时，还为广大客户提供手机商城、证券服务、存贷款计算器、机票酒店预订等便捷生活服务。
模拟炒股	　　中国地区最受用户喜爱的炒股应用！
网格网络币	　　网格网络币交易软件算是一款区块链交易平台挖矿+趣步模式结合的交易平台，
爱心帮扶	爱心帮扶LOV正在空投，注册并通过实名认证，获得矿机一台，邀请补，社群补，等级制度达人团队化推广!
卡牛信用卡管家	　　【多重保障】　　大品牌打造，用户数据安全有保障；　　支持狠到位，随手网服务有口皆碑；　　数据非实名，用户与数据无任何关联；
光大金阳光	　　金阳光移动证券是光大证券为客户鼎力打造的全新一代移动证券平台，为客户提供专业的证券行情、交易、资讯服务。金阳光移动证券采用多项业内领先技术，使行情更快捷、交易更安全、资讯更及时，为客户提供全方位的专业证券服务。
WenX交易所	WenX交易所是一款非常不错的金融理财类手机软件，WenX交易所官方版有着大量的区块链信息，WenX交易所官方app可以让你在线快速的进行数字货币交易哦！
走路计步宝	　　走路计步宝app是一款全新上市的赚钱软件，你可以使用软件更好的进行走路赚钱，同时软件具有海量运动任务，各种类型一应俱全，你可以更好的进行挑选，并且软件操作简单便捷，还可以随时随地进行查询，海量现金红包等你来领，并且软件操作简单便捷，海量新人任务，还可以更好的进行各种提高赚钱等等，还可以进行运动记录等等。
VIP账本管家	软件介绍
炜爱金融	　　炜爱金融app是掌上投资赚收益和邀请分成的理财新平台。
记账赚钱	记账赚钱app是一个记账理财赚钱工具，以其专业的数据统计分析、强大的云端数据库、丰富的账本管理工具，成为100万用户的共同选择！通过坚持记账，帮你树立经济理财意识，培养财务独立的习惯。做您满意的记账省钱赚钱app！让每一次记账都是生活的直播！
记账吧	记账吧app是一款轻便，简洁还会让你赚钱的记账理财好帮手。记账吧app帮你记录每一笔消费，做到心中有数，月月有余。用了记账吧app这款记账软件，再也不担心钱花哪儿了，还能真真实实的赚钱！日前超千万用户都在使用这款超棒的软件！
健康赚	　　健康赚是一款提倡全民健康运动，提升运动乐趣的app。
客商数字银行	客商数字银行app是梅州客商银行旗下的数字银行，面向线上互联网客户，支持用户在线开通II类账户，实现绑卡、充值提现功能，购买存款、理财等金融产品，以及提供抽奖、积分、红包等营销活动，满足用户多元化、个性化金融需求，让智慧金融服务触手可得。
记账365	记账365 app是你生活的记账专家。记账365 app用简洁的方式，记录每一笔消费，将收支图表化，设置预算提醒，让你的信用生活更加精致！记账365 app可以记日常收支、生意流水、旅行开支、家庭收支等多种账目，您可以添加多个账本，来记不同的账。
走走赚钱	　　走走赚钱app是一款以计步为主要功能，为用户提供基于步数相关的健康参数的App。鼓励主张绿色、低碳的生活方式，让走路的每一步都变得有意义。
计步宝	　　计步宝app是超级好用的一款运动赚钱软件，在这里您每天进行走路运动是会获得金币奖励。“计步宝”APP可以帮助到更多网赚爱好者，利用在线运动的方式，让大家把每天的走路、散步步数兑换为现金收益。每天都会发布各个等级的走路任务，走的越多赚的越多，还能签到打卡，喜欢的小伙伴们赶快点击下载吧！
股先森	　　股先森是一款强有力的理财炒股软件，股先森为股民推荐切实可行的炒股策略和老师为大家推荐真实的投资经验。股先森从同花顺、大智慧、通达信、操盘手等同类理财炒股软件中脱颖而出，是具高潜力的炒股工具，炒股当然股先森！
荔枝财经	　　荔枝财经app每天5分钟，炒股更轻松！荔枝财经app让您：花最少的时间，学最多的东西，荔枝财经app一个真正为投资者做实事的股票APP，我们的每一个内容都在为您考虑！
划时空奖金版	　　划时空奖金版app是一款可以发布自己歌曲的手机软件，你的歌曲点击量越高，你的收益也会越高，在这里你不仅能够做这自己喜欢的事情，划时空奖金版app还可以展示最优秀的自己，感兴趣的小伙伴们不要错过了，赶紧来下载体验吧。
裕民银行	　　江西裕民银行app全新上线，新服务、新体验，为你而来。
微众企业爱普	微众企业爱普app是腾讯牵头发起设立的国内首家互联网银行，持有银行牌照。微众企业爱普app为小微企业主提供账户查询、转账支付、银企对账、业务咨询等金融服务，让小微企业直通银行。
发发问股	　　发发问股app是一个既可以提问也可以赚钱的理财平台，发发问股app为广大股民朋友们提供实用的股票资讯服务，在发发问股app内有专家在线直播讲解，还可以参与话题讨论，好股分享等等，发发问股app是广大股民朋友们必不可少的炒股助手之一。
卡帮主	　　卡帮主app是一款推荐办理信用卡有福利，成功分享好友能拿钱，高至100元每张，多劳多得的掌上信用生活，快来体验吧，软件内更加多样化的信用卡产品，能够满足你全方位的用卡需求，购物，出差，旅行等全都有，还可以在软件内查看各家银行实时优惠活动，快速便利的帮您省钱，没时间线下购物，来这里，为你提供购物商城，足不出户更多优质商品供你选择，重要的是刷卡还能返现，更享各家银行开户礼。
炒牛股	　　炒牛股app是一款炒股必备的APP，找牛股抓涨停，一个APP全部解决，炒牛股app有着极速行情，要闻推送，实时跳动的毫秒级行情信息，带你随时查看股票走势分析，炒牛股app让你随时掌握市场动态。
安收宝	　　快钱安收宝是一款刷卡软件，可以轻松进行卡刷服务，以商家收款为特色，随时随地方便进行收款，让大家刷卡更加的轻松方便！快钱安收宝集成各银行,专业资格的第三方支付清算机构通道，为商家提供最便捷的收银软件，支付宝二维码，微信二维码，银联二维码，百度钱包，qq钱包。京东钱包二维码，翼支付二维码！
宝贝支付	“支付”诞生在阿里巴巴张江创新中心，拥有强大的技术背景做支撑，产品上线已获得百万用户的青睐！
股拍	　　股拍app专业的证券视频社区，股拍app让您可以利用碎片化时间，随时随地快速洞悉市场热点，股拍app把握投资先机，轻松玩转股市。
将军财富	　　将军财富，一款专为广大股民打造的大数据智能选股APP。
容维财经	　　一款强有力的理财炒股软件
ETF组合宝	　　etf组合宝手机版是一款专业的理财平台，ETF组合宝app提供了丰富的理财技巧，用户通过ETF组合宝app可在线学习快速成为理财大神，ETF组合宝app支持在线交易，超多奖励不断更新，免费拿提现到账速度快，欢迎免费下载ETF组合宝app使用体验。
AI理财师	AI理财师app是一个金融投顾的智能理财工具，AI理财师app专注服务理财师，提供“营销获客、理财分析、智能服务”的核心功能，实现与iFinD终端云端互通的安全理财工具，帮助理财师提高效率提升服务。
众赢财富通	众赢财富通手机版为用户提供投资咨询、实战培训服务。投资咨询即为广大投资者提供深入、及时、稳健的证券资讯，并提供稳健的投资计划、资金管理、投资组合及操作建议等咨询服务，众赢财富通手机APP实战培训则为广大投资者提供简明实用的实战操盘技巧和投资心智模式培训。
令牌	　　令牌app是一款手机区块链赚钱软件，用户可以在平台上看到各种相关的区块链信息，每天都会实时更新区块链的最新消息，让用户每天都可以看到最新的市场消息，还有各种币种的交易行情，所有的数据全部连接交易所，让你可以轻松查看各种交易行情，用户也可以在平台完成各种币种的数字交易，平台有数字钱包加密功能，用户可以放心使用。
中泰国际环球易	功能介绍
勒沛影视	
卡医生	　　卡医生app是一款高效、简便、实用、安全，结合了信用卡管理和分销模式的APP工具。卡医生app该产品在移动端首创了通过智能管理信用卡电子账单，来实现持卡人用卡信息管理和个人财务的智能化应用，同时，卡医生app还运用了分销模式，为智能推广提供了极大可行性。
资产星球	　　资产星球Dapp是基于“链斯达克”共创链的一款信用卡账单管理应用，资产星球app可让用户在信用管理、信用提升、信用应用等正面行为而获得实体通证化的积分，这些积分可以有各种兑换价值，以此来鼓励用户养成良好的信用习惯。
洪泰财富	　　洪泰财富app由洪泰财富（青岛）基金销售有限责任公司开发，公司创立于2016年，由国内著名投资银行家盛希泰先生亲任董事长并特邀多名资深优秀金融菁英加盟组建，致力于为投资者提供专业、多元、最具价值的财富管理解决方案。
启点金融	　　启点金融app是杭州启点资产管理有限公司旗下的互联网理财信息中介平台，总部位于杭州。启点金融app致力于为投资者提供安全、专业、便捷、高效的创新性互联网理财服务，降低投资者的投资门槛，多渠道增加居民财产性收入。
淘一卡管家	功能介绍
红牛股票	功能介绍
银河期货期权	　　银河期货汇点股票期权交易系统手机版（只适用于安卓系统手机），该软件可免费查看上证50合约的行情信息，银河期货有限公司股票期权客户还可登录该软件进行股票期权交易。
币响	功能介绍
苏E付	更新日志
鼎刷	　　汇付鼎刷成为汇付天下旗下品牌，面向高端信用卡群体，由汇付授权于上海慧管信息技术有限公司运营。专注于无卡支付和银行卡收款，将成为汇付旗下继速刷，闪电宝之后又一个引领支付行业的品牌。提供便捷、安全的移动支付服务平台。我们支持银行卡、支付宝、微信、无卡等多种收款方式，并提供信用卡还款等便民服务。
金猫管家	软件特色
兴泰村镇银行	　　兴泰村镇银行手机银行客户端为太谷县兴泰村镇银行专为客户打造的移动金融服务平台，兴泰村镇银行手机版在具备转账汇款、定期存款、交易查询、账户管理、网点地图等常用功能的同时，兴泰村镇银行手机版还为广大客户提供“定转存”等理财产品、存贷款计算器等便捷生活服务。兴泰村镇银行手机版简练、流畅的界面设计，新颖实用的功能让您充分享受兴泰村镇银行的便利服务，兴泰村镇银行手机版时时刻刻竭诚为您服务！
达州银行	　　达州银行app是一个为智能手机和移动终端用户量身打造的移动金融服务平台，达州银行app创建“常用功能”、“个人银行”、“我的惠银”、“更多服务”等金融服务专区，为您提供丰富实用的金融服务。
集金智投	　　牛市熊市都能赚钱的APP!
金龟理财	　　1.双11活动：精品爆款，签到红包领不停　　2.新手有礼：8888元体验金、12.88%超高收益、6000元本金券　　3.首投惊喜：15天新手标，专享8.8%惊喜收益　　4.邀请好友：N次百分百中抽奖机会；好友首投5%收益返现　　【平台优势】　　1.合规：银行存管正式签订，风险准备金、质保服务专款陆续上线　　2.组合：多款期限产品和爆款活动，随心获利　　3.稳健：量化分散投资，创新四重风控保障，投资更可靠　　4.安全：银行级加密数据传输技术，更强的账户资金保障　　5.简单：5秒快速注册，闪电投资，快速起息，提现T+0
普惠通	　　普惠通app是一款普惠金融一网通应用App，普惠通app旨在为用户提供普惠授信、账户管家、金融超市等一系列信息技术服务，利用普惠通app可协助用户在线申请“普惠授信”等产品，普惠通app致力于为农民、小镇居民、个体工商户等弱势群体提供相关服务的移动信息服务产品。
亿联银行	　　亿联银行定位为“以客户为中心，以科技为驱动、发展普惠金融为宗旨”的智能网络银行，通过大数据、人工智能、云计算等科技技术，在“衣食住行用”等各种场景中移动互联各个平台，为广大个人消费者和小微企业主、小微企业提供存款、贷款、理财、汇兑等金融服务。
金色财经	　　金色财经作为一款垂直性区块链新闻资讯 App，区块链创业者必备，让用户准确及时获取想要的头条新闻资讯，涵盖区块链、数字货币新闻资讯，实时数字货币行情走势，我们追求及时、全面、专业、精确的资讯与数据，致力于为区块链创业者以及数字货币投资者提供最好的产品和服务。
金手指农盘	　　金手指农盘app提供投资者证券、期货分析工具，提供行业最新资讯，热门动态实时更新，数据显示一目了然，在线开户交易安全有保障。在工作之余学习投资理财技巧，熟悉金融相关投资知识及操盘技能等。系统功能全面，快速稳定，界面操作友好。简单易上手，是用户投资的理想工具。
逗赚	　　逗赚app，一个趣味的兼职赚钱平台，边看电影边赚钱!带领全民掀起轻松赚热潮!随时随地，只需要通过一部手机操作聊赚，轻松做到想赚就赚，后期将不断更新更多劲爆功能!
中金国泰	　　中金国泰理财网是上海中金国泰金融信息服务有限公司旗下互联网金融平台，位于上海金融中心陆家嘴，注册资金1个亿。
贝壳金控	功能介绍
招行小白卡	　　小白信用是京东金融消费金融业务的重要组成部分，目前与银行合作推出“小白卡”已呈规模化和常态化。
港版支付宝	　　支付宝宣布推出香港版电子钱包DD支付宝HK，据悉，这是支付宝第一次发布境外版App。
东吴秀财	　　东吴秀财是东吴证券为广大互联网用户量身定制的财富管理平台，致力于为个人投资者提供专业、及时、强大和个性化的理财服务。自助开户、行情交易、基金理财、投顾资讯、业务办理、社交分享等丰富业务功能全线开通，是广大互联网用户自助理财的利器。
紫金农商银行	　　●转账免费：即日起至2015年底，转账0费用，每日高达100万元的转账汇款额度；
涨乐财富通	　　以“乐享智能”为主题的华泰证券涨乐财富通APP5.0发布会在南京举行。在人工智能浪潮下，如何为客户提供更便捷、更简单的理财服务工具，成为国内券商共同面临的课题，目前来看，华泰证券成为了首批交出答卷的券商之一。
颤音	　　颤音app是一款短视频赚钱平台，用户可以在软件上进行短视频的浏览和观看，就可以赢得金币，其中有很多实时火爆的话题，非常受用户欢迎，新用户注册还会有奖励，用户每天空闲了就可以刷短视频还可以赚。感兴趣的朋友欢迎前来下载体验吧！里面的短视频都是每日更新的，还会根据用户平时所喜欢的类型进行智能推荐哦，更多红包奖励可以领取，活动超级给力，意想不到的惊喜提供给大家，有喜欢的用户们快来下载吧！
柚子码接码	　　柚子码接码平台app是一款可以通过完成兼职工作来得到奖赏的软件，全面更新全网所有正规安全的兼职工作，根据每个人的喜好来自由挑选任务，平台上的规则都差不多，只要按照相应的要求来完成举行，每天可以挣的钱都是不固定的，只要你每天做的越多那么赚的就能越多。
济宁银行	　　1、IC卡认证，全新NFC认证方式，安全更可靠；　　2、小额免密免签、定向账户免签，小额和定向账户的转账更为方便快捷了；　　3、快捷支付签约，手机银行上也可以进行第三方的快捷支付签约了；　　4、手机号转账全新升级，跨行转账也不用愁了；?　　5、我们还对客户端进行了优化，提升了客户端的稳定性。
东航金融	　　监管严格 ，投诉有门　　作为国家中央企业东航航空集团的全资子公司，我们重视并遵守有关规章制度并以最高水平维护客户的权益。　　资金分离，安全可靠　　按照香 港证监会规定，客户资金必须与持牌公司资产严格分离，最大程度保护客户的资金安全。　　开户程序高效规范　　客户开户签署正式开户协议正本一式两份，我们会在1-2个工作日内进行律师事务所开户鉴证流程，并有执业律师在每份开户协议上签字。 东航金融持牌人签署盖章后随密码信寄送给客户。
老虎证券	　　老虎股票APP，完全以中国用户习惯设计，无需线下见证或视频见证，一个身份证轻松拥有海外投资权限，入金交易，投资全球最好公司，分享科技浪潮与红利，踏上追求财富自由之路！
星火理财师	常见问题
招钱宝	　　招钱宝APP是招商基金管理有限公司全新打造的移动理财利器，具有门槛低、取现快、产品多、费率低、资产全等优势，带您轻松实现财富稳健增值。
块链星球	　　聚链星球app是一个拥有更多挖矿产品能自由选择的科学挖矿助手，这个块链星球挖矿平台的环境会比较的安全可靠，块链星球app让投资者都可以很放心的去投入资金理财，各块链星球交易平台拥有种不同的挖矿模式都可以体验一下，给大家带来的挖矿收益还是特别可观的。
OTR奥塔	软件特色
龙之子区块链	龙之子区块链app给广大的亲们带来了一个专业的理财平台，直接在这里就可以了解到多种理财产品哦！您热衷于哪一款理财产品都是可以直接线上申请投资的哦！这里每天都会更新区块链行业的相关行情走势，轻松get理财一手信息哦！非常简单的就可以获得对应的收益哟！喜欢挖矿喜欢区块链的亲们别错过呢！
BSEC块购链	BSEC块购链正在空投糖果,基于区块链的电商平台,开盘前三天注册认证送两台体验矿机,矿机和电商省赚结合,接入淘宝、京东、拼多多灯,团队化推广!
dac交易所	　　dac交易所app是基于区块链开发的一款挖矿软件。用户可以在dac币挖矿挑选自己喜欢的任意挖矿任务，在线挖出财富出来，这款dac交易所软件赚钱非常的轻松，用户可以一键在线进行注册登录，新用户首次使用是会赠送挖矿机的，dac交易所app帮助你可以更好的进行挖矿，每天都有挖矿机赠送，让你的财富可以得到累积这款软件挖矿赚钱非常适合在家没事做的用户使用。
飞天比特FTC	飞天比特FTC，推荐给大家，这是款能够进行在线挖矿赚钱的软件，在小伙伴们通过这款软件进行挖矿的时候是能够赚取到超级多钱的哦，而且在这里赚取到的钱还都是非常丰富和稳定的哦，是能够让小伙伴们不间断获得零花钱的哦，还在等什么，快来下载吧！
pocc投资	　　pocc公链是一款皮皮虾官方打造的手机挖矿平台，pocc挖矿功能强大内容丰富，pocc虚拟货币帮助大家轻轻松松的进行手机在线挖矿赚钱操作，不需要什么条件和门槛，谁都可以来试一试。
酒创富	　　酒创富app是基于区块链技术的酒类财富分配平台。酒创富软件通过酒类生态文化实现美酒价值流通，支持云端矿机挖矿，美酒生态交易、利润分红等功能，酒创富app的玩法多样，操作简单，在酒创富app中你可以挖矿获得虚拟货币。用虚拟货币可以参与市场交易买卖，也就是获得金钱，这就是酒创富app的理财方式。
IPC公链	　　IPC公链app提供给用户们的是一款全新的区块链赚取收益的软件，
KrSys	　　KrSys app是一款全新的区块链投资平台，采用的是很多区块链新模式。线上的挖矿项目是非常的多的，大家是可以在线上进行各种挖矿操作的，能够通过每天的挖矿获取不错的收益的。直接注册平台，然后填写自己的个人信息就可以使用平台了，线上的区块链数据信息都是可以直接查看的。这里能够随时关注交易数据的，给大家分享的都是真实的交易信息。
高通邮币世界	　　高通邮币世界app是一款近期才上线的手机软件，主要是针对手机在线去进行虚拟币区块链赚钱打造的便捷平台。
财神驾到	　　财神驾到app经过多次升级后，已经不再只是选币系统，而是更智能、更简单、更直接的盈利系统。
趣链科技	　　趣链科技app是一款非常受欢迎的手机挖矿赚钱软件。趣链科技app有多重安保系统，非常的安全靠谱，专业人员在线汇总资讯，让你随时可以知晓币圈的各种动态，丰富理财项目直接推送在首页，看到好的项目可别犹豫，把握时机加入就能赚到丰厚佣金。
WEE区块链	　　WEE是一个基于区块链、以太坊技术打造的，专门服务于全球环保事业、能源开发的公益性平台，通过WEE值的全球性扩散，让每一个人都能关注和参与到全球生态环境的保护和建设！
qwallet区块链	qwallet是一款手机挖矿赚钱的软件，最新上市就深受很多用户朋友们的喜爱，用户们在这里还可以随时的查看和了解最新上市关于区块链方面的知识，喜欢的用户们可以随时下载这款软件进行体验，新用户们现在下载使用还可以领取丰厚的奖励，你还在犹豫什么？一起下载一起轻松赚钱吧。
FDS币	　　FDS币是首个以社区利益为核心的发行机制。
泉州银行	软件特色
广州银行	　　广州银行手机银行针对iPhone智能手机、IPAD平板电脑及安卓系统的平台特点，设计了安全、便捷的用户操作界面，提供全面的移动金融服务，是客户移动理财的好帮手。　　门户功能：客户无需登录手机银行即可使用手机银行门户提供的金融和资讯服务。包括：营销快讯、本行动态、网点查询、信用卡、金融助手、客户服务等功能。　　客户登录手机银行后可以使用账户查询、挂失、积分管理、限额查询及修改、转账汇款、理财产品、基金业务、储蓄增值账户、自助预约、缴费支付、信用卡服务、个人贷款查询、设备绑定等功能。
上海农商银行	　　为您提供账户管理服务，包括添加或删除手机银行的注册卡号、查询卡余额和交易明细。您可以及时掌握银行卡的余额变化和交易明细。　　- 账户管理：提供手机银行注册卡的添加和删除功能，还可将卡号和手机号进行绑定，在他人给您的手机号转账的时候作为收款账号。　　- 账户余额查询：实时查询账户的余额。　　- 账户明细查询：实时查询账户的交易明细
闪金大亨	软件介绍
广发掌上开户	　　广发掌上开户全新体验！ 指端上开户，掌心中运筹！沪深A股账户、基金账户、统统掌上搞定，十分钟内快速开户，助你轻松驰骋资本市场，遨游股海风云！广发掌上开户，你值得拥有。
中山赢者同花顺版	　　中山赢者同花顺版app，中山证券官方出品的手机炒股软件，集交易、资讯、行情为一体，为投资者们提供最新、最全、最快的市场资讯、网上行情和最安全的交易平台。
华林证券	　　华林证券为手机客户量身定做的全新移动炒股软件，全新界面，操作极具简便快捷性，软件运行速度快，提供及时丰富的多市场行情、资讯服务、已经最快捷安全的委托交易、融资融券等功能。让您可以随时随地免费进行证券交易，把握转瞬即逝的投资良机　　整个系统采用最新加密技术，安全性极高，本软件使用完全免费　　华林证券有限责任公司成立于1988年7月，是国内最早成立的综合类证券公司之一。公司总部设在深圳，目前在北京、上海、广州等大中城市设有分支机构，业务覆盖全国。经过多年的稳步发展，公司的法人治理结构和合规风险控制体系日趋完善，建立了适应市场发展趋势，满足客户需求的灵活运营管理机制和决策机制。目前，公司的经营范围涵盖证券经纪，证券投资咨询，与证券交易、证券投资活动有关的财务顾问，证券承销与保荐，证券自营，证券投资基金代销、证券资产管理等，业务品种齐全。目前，公司以投行业务为引擎，加快向现代财富管理机构转型的步伐，提供综合金融服务。
广发证券易淘金	　　广发证券2015年新版APP（业内创新顾问式投资理财软件），看行情免.流量！“广发证券易淘金”是一款集股市行情、股票交易、在线理财为一体的证券/炒股/理财/投资/财经/金融软件，它具有人性化的界面，快捷的交易功能、强大的到价提醒、丰富的财经资讯和多款理财产品，支持多终端云同步自选股。广发证券为您提供优质服务，助您轻松炒股决策，掌握丰富投资机会！移动用户下载APP并使用即可享受此优惠！
威海银行手机银行	　　手机银行系统是指我行为智能手机和移动终端客户量身打造的移动金融服务平台，利用安全的身份认证和网络通讯技术，为客户提供账户信息查询、转账汇款、二维码收付款、充值缴费、定活互转、投资理财、资金归集、手机取款、我的贷款、网点查询、个人设置等7×24小时全天候不间断自助电子金融服务的系统。
中山赢者手机版	　　中山赢者手机版，中山证券官方出品的手机炒股软件，集交易、资讯、行情为一体，为投资者们提供最新、最全、最快的市场资讯、网上行情和最安全的交易平台.
宁波银行	　　产品功能包含：
渤海银行	　　渤海银行手机银行客户端适用于安卓系统用户。新版客户端延续了渤海银行原客户端（WAP版）的核心内容，充分体现出电子银行安全、便捷、易用的特点，优化了原有转账、查询等基础功能，明显缩短了客户等待时间。新增了“信用卡还款”、“快捷转账”、“AA生活”等特色服务，引入智能存储模块，把繁琐的步骤简化为一键操作，并为年轻族群提供了多方案复合的AA账单计划，发起活动，分配账单轻松搞定。
方正证券小方	　　【轻松开户】
码库	　　码库app是一款可以统一管理数字通证，数字积分的工具APP。码库app提供了简介明了的界面，让您可以在一个界面上管理不同的积分或数字通证，码库app还提供了各种图形报表，让您可直观的了解积分的变化情况。
江苏银行	　　江苏银行秉承“融你我、融无限”的理念全力打造安全易用的“随身”银行，让您畅享移动金融服务。
东方财富	　　东方财富网APP全新升级为东方财富APP；东方财富网是中国财经第一门户，用户超过1亿，沪深港美全球实时高速行情， 7*24小时全天候财经直播，囊括上海证券交易所3项大奖，5星好评，被AppStore评为精品应用，拥有中国人气一流的股票主题社区DD股吧。
牛股王股票	　　全民炒股时代来临，预示着一个新赚钱时代的到来；中国股民能真正炒股赚钱的少之又少，牛股王为中国股民而生，让亿万股民赚钱变得简单而又快乐！
日照银行	　　日照银行提供普通银行金融业务外，还提供自助注册、手机地图、找回登录密码等特色功能，其中“金融助手”、“公共服务”两个模块中的功能无需登录手机银行即可使用查询，简便易用。
中信银行	　　中信银行手机银行开通渠道有三种：网点开通、网上银行开通和客户端自主开通。用户可根据需求选择便捷的方式。用户登陆时可以自主选择银行卡号、身份证号或者登录名之一登录。
天天基金网	软件特色
东营银行	　　本产品是东营银行为Andriod用户量身打造的手机银行客户端，满足客户随时随地能够安全便捷地管理自己的资金和享受银行服务的需求。除了普通银行金融业务外，还提供自助注册、手机地图、找回登录密码等特色功能，其中“金融助手”、“公共服务”两个模块中的功能无需登录手机银行即可使用查询，简便易用。
猫猫记账	　　猫猫记账app是一种日常，更是一种习惯。怎么花钱？怎样省钱？怎么赚钱？银行卡余额越来越多，房贷车贷轻松搞定，从记账开始，每一笔收入支出清楚明了，再也没有糊涂账。
应用试客	　　1.海量任务顶级单价　　2.史上最强手机赚钱的最佳选择　　3.免费发红包，好友多多，收益多多　　4.坐享其成，会员等级，推荐等级，好有奖励最高提至20%
东方财富通	官方介绍
FTI矿工	　　FTI便捷与优惠的云算力租赁服务计划,致力于为用户打造便捷的云算力租赁服务,
阳光币	　　阳光币app是一款汇集多种不同功能的挖矿软件。通过这款阳光币软件你要可以体会到各种不同的挖矿项目，这些项目的玩法非常的多元化，用户随时可以根据这些不同的项目享受到各种不一样的便利，同时在这里只要注册就可以得到专属的矿机，让你可以更好的在线产矿币，其操作也是非常简单，用户可以更好的体验不一样区块链带来的玩法。
PIC公益币	PIC公益币正在空投，注册并通过实名认证，获得矿机三台，邀请激励，团补，团队推广模式！
芈商	　　芈商app是刚出的一款不需要投资就可以零撸的暴力项目，
EthSkytrix	　　ETHSKYTRIXis第一个带工作交换令牌的矩阵系统(ESKT)
DDC多多链	　　DDC多多链APP是一款可以在手机上去进行区块链虚拟币交易打造的平台，
渤海云店	　　渤海云店app是渤海银行旗下的，用户微信扫码注册送200积分，
BTC联盟	btc联盟是一款手机赚钱软件，新用户们下载使用该软件可以免费的进行挖矿机器的领取，在这里你们不需要花费很长的时间就可以轻轻松松的赚取很多的金币，你还在认为手机赚钱不现实吗？不妨现在就拿起手机下载这款软件体验看看，这里还可以进行领取任务的方式赚钱哦。
昊韵比特社区	昊韵比特社区app是一款很是专业的区块链互动交流社区软件，汇聚了超多喜欢区块链的玩家们在线，大家随时可以轻松的进行交流，可以相互从中学习到更多的理财技巧，同时还可以关注到行情最新资讯，有着许多的产品进行关注，相信你会非常的喜欢这里。
星盾科技CDN	星盾科技CDN正在空投，注册并通过免费实名认证，获得1000赠送合约，邀请即可升星，支持ERC20_USDT，团队化推广!
淘金区块矿	　　淘金区块矿app是款热度比较高的挖矿赚钱平台。淘金区块矿app为用户准备了非常多的矿机，用户可以去进行线上注册然后免费的去进行领取，用户就可以去进行线上的挖矿的，支持二十四小时的挂机挖矿，用户可以躺赚睡觉赚钱，并且还为用户提供了许多的其他等级矿机，能够加快用户的挖矿速度，更好的带来收益！
恒星交易所	　　恒星交易所app用搭建一个数字货币与法定货币之间传输的去中心化网关，是一个用于价值交换的开源协议。
全民数据链	　　全民数据链app是一款全新上线的区块链赚钱平台，线上让大家可以自由的挖矿理财，手机上面就可以轻轻松松的赚钱，每天这里的为大家准备丰富的矿池资源的，在你的空闲时间就可以来这里挖矿，帮助更多的用户可以得到赚钱啊机会哦！
not区块链	　　not区块链挖矿依托自有/合资BTC矿场，提供BTC矿机托管、云算力租赁挖矿、行情分析、BTC委托卖出等一站式服务；
星网云矿	　　星网云矿app是一款最新推出的手机挖矿赚钱网赚平台.
央行d豆	央行d豆app官网最新版是一个有虚拟货币最新的资讯信息，大家能齐聚一堂浏览各种虚拟货币内情，能更好的进行货币顾投和置换的一个综合区块链中心，让大家能看数字货币的最新消息，能知道怎么去顾投，能学习知识，能直推获得奖励的一个区块链平台就在央行d豆app！
中联沃家	　　中联沃家app，一款最新的挖矿赚钱项目推荐给感兴趣的朋友，
区块名品链	　　区块名品链起航。源码独创，打造属于独一无二，多元化，多功能，别的项目有的，我们也有。
tep币	　　tep币交易平台首发，刚上线产品就被抢购完了，就剩10元的产品了。悬赏佣金5元，相当于5元赚40！里面的币直接就能提现不用交易不用实名
凤凰城	　　凤凰城区块链app为用户们提供了一个非常安全可靠的区块链交易平台，
EOS区块链	　　EOS区块链是一款非常简单的挖矿赚钱平台，操作简单，适合所有人使用，用户注册登录就可以获得平台赠送的矿机，矿机可以自动帮你挖矿获取收益，还可以邀请自己的好友跟你一起赚钱，平台里面还有许多的任务可以领取完成，每天只需要抽出一会儿的时间，就可以赚钱了。
CBDC	　　cbdc央行数字货币app是一款非常安全可靠的移动区块链交易所软件。
infd交易所	　　InfinityDeFi 是一个多层发行平台、抵押品类型的交易系统，允许任何互联网用户，创建从加密货币到法币，再到衍生品的复合资产。
掌上龙珠	　　掌上龙珠app是一个可以赚钱分红的视频应用，登陆注册送神龙，每天为你产出龙珠，不管是自己看视频，还是推广给朋友们一起分享，都能够获得龙珠奖励，也就是通过看视频的方式来获取平台币的奖励，交易变现来获得真正的收益，玩法简单，收益有涨幅，币的价格后续会慢慢涨的。
爱奇艺i联盟	　　爱奇艺i联盟app是一个推广赚返佣的平台，大家都可以免费加入哦，主要就是推广爱奇艺的会员卡，赚提成返佣，赚的钱会打到你的爱奇艺钱包，之后就可以提现啦。
DST交易平台	　　DST交易平台app是一款优质的虚拟货币交易平台。DST交易平台app这里为用户带来全新的区块链交易模式，还有超丰富的矿池资产等你来体验，超严格奖励制度让你赚更多，还有超丰富的矿池资产等你来体验，由于刚上线所以活动特别多，新用户注册就送矿机，每天签到可以领取DST币。
十度广告	　　十度广告app是一款刚出的新平台，在十度广告app这里可以发布推广项目，不仅可以增加曝光度，还可以赚钱，最高可获得八级广告拥挤的收益，而下级越多，你的收益也是源源不断的，这个收益是源源不断的，同时2元激活获得公排位置，系统自动分配人员给你，把他们激活的金额通过系统返还到你的账户，这个收入可能几千，几万几，百万！推广十度你将打开一个新的世界！一个双向收益！
丽时空商城	　　丽时空商城app是一款刚上线不久的优惠购物平台，丽时空这款软件里面的商品非常实惠亲民、物美价廉，通用户可以做任务得积分，丽时空商城app目前是没有强制大家购物的，而商家也可以免费入驻，变现的话，丽时空app内置交易中心，可以直接进行变现的哦。
趣商联盟	　　趣商联盟app是一款通过做任务来赚钱的平台，趣商联盟全部的过程都是只需要在手机上去进行即可，不定期的每天去上新众多的任务，趣商联盟将会方便用户去进行结合需求选择的。各种在线上的网赚的各种专属的平台都会有，趣商联盟还有每天的签到领红包的专属的功能，轻松实现手机端的网赚。
kibiex交易所	　　kibiex交易所app是一款全球领先的加密货币交易所平台。kibiex交易所主要帮助用户管理自己的虚拟资产，用户注册需要实名认证才能查询自己的数字货币，更有最新的区块链资讯和项目方面的信息，通过对行情数据和K线变化趋势的分析，让你掌握区块链的发展状况，所有内容都是可以免费查看的，还有安全可靠的交易系统可以使用，提高自己的交易效率。
财富卷轴	　　财富卷轴app是一款专为用户打造的安全可靠的赚钱平台，现在注册就能获赠平台币，每天在线参与抢购卷轴就可以持续获得收益，操作还是很方便的，卷轴等级越高产出的平台币也就越多，邀请好友也能领取额外的分红，提现手续费还是很低的，当天就能到账，让你更快捷的赚到零花钱，喜欢的朋友千万不要错过。
INDEXS	　　INDEXS交易所是一款专为用户开启数字狂欢的手机区块链app。线上平台有着四大活，百万ETH资产等着你来拿哦！在INDEXS数字交易所这里，用户邀请的好友越多，那么将会赚取的ETH数字奖励也就越多哦！并且该区块链平台支持不同的国家，不同地区的用户进行登录交易，非常的安全可靠。
AMZO	　　AMZO挖矿app是一款世界领先的虚拟数字货币交易工具，专为用户带来非常全面，综合的区块链一站式挖矿体验。线上平台有着非常丰富的数字资产数据信息，专为用户打造出一个流畅省心的挖矿交易体验。并且AMZOapp提供多种数字资产专为用户进行在线交换哦！并且该挖矿平台还能够安全的保护用户的数字资产。
YOOBTC	　　yoobtc交易所app是一款非常优质的手机数字货币一站式交易工具。yoobtc交易所app专为广大的区块链创业者带来一站式的区块链数字资产服务。在YOOBTC交易所app平台上，用户每日都能够预览海量的区块链文章内容，以及诸多币圈的行情数据信息，方便用户掌握最佳的区块链数字财富。
LavaMoney	　　LavaMoney交易所app是一款区块链货币对接交易平台，一款专为用户带来最有态度的手机高级赚钱app，在这里，专为用户保证百分百能够赚取海量的Lava数字资产财富。线上LavaMoney交易所平台的币算方法也是非常的简单，并且该Lava币的存储量也是非常的大，用户可以放心的交易，放心的进行数字投资赚钱。
EBcoin易币	　　EBcoin易币app是一款关于数字货币的资讯软件。EBcoin易币app实名送产11币矿机，5币起卖，签到得可售额度，团队收益。已注册的100个矿池资产的可售配额。可售配额可以转移到矿池钱包，然后从矿池钱包转移到矿池资产，无需担心。交易打开后，您可以获得购买硬币的相同的矿池钱包限额。只要您每天坚持，配额就不用担心。
MBT矿工	　　MBT矿工区块链平台是一款非常受欢迎的手机挖矿赚钱软件，新用户注册并通过实名认证，获得10000矿池和1台矿机，并且邀请好友还有分红奖励，操作起来非常的简单，还是大家所熟悉的挖矿模式，适合更多人群在线操作赚钱。
易丰会	　　易丰会APP是一款非常受欢迎的阅读文章转发赚钱的平台，这里每天都会发布各种最新文章资讯，用户只需要根据自己喜欢阅读的文章来转发就行，完成一定量的任务就能获得不菲的佣金，每条任务都不会花费太多的精力和时间，对用户来说是非常好赚的任务方式，与资讯阅读类，新闻转发，线上小游戏试玩等等多种赚钱的机会，任务类型很多，大家可以根据自己的需求来选择。
众博云购	　　众博云购app是一款为用户提供在线赚钱的服务软件。这款众博云购软件的赚钱方式非常的简单，平台的赚钱任务非常的丰富，有推广赚钱、还可以通过购物来获得收益，最重要的是用户可以通过这款软件在线领取时段金币奖励，同时用户推广的人数越多，获得的收益也就越多，这款软件的佣金是非常的可观的，赶快来一起赚钱吧！
广益科技	　　广益科技app是一款全新的手机兼职平台，这里的任务种类非常的多，如果想多赚钱就多做任务，如果想自己轻松一点就可以少做一点任务，这个都是可以自由安排的，没有什么时间的限制，让你在家躺着就可以赚钱，同样还能够选择多个任务去做，没有很高的要求，大概就是一些关于阅读、转发或者点赞的赚钱任务，需要的朋友可以来试试。
手淘隧道	　　手淘隧道app是一款真实可靠的接单赚钱软件。手淘隧道平台与众多电商平台的商家合作，每天都会发布大量的订单任务可以选择。手淘隧道app系统可以自动为用户派单，做单过程非常简单，本佣立返，没有任何风险。
钱工盈	　　钱工盈是一个非常火的兼职任务赚钱的软件。对于很多小伙伴来说都想在自己的闲暇时间做点兼职啥的赚赚生活费，新用户注册即可享受平台俩天内的红包翻倍收益奖励哦！在这里，用户只需每日做做任务，就能够轻松赚钱哦！线上钱工盈app平台专为用户带来零套路，零投资的网赚任务，专为用户开启一个不一样的兼职任务之旅哦！
红9庄园	　　红9庄园app是一款最新上线的专门供大家挖矿赚钱的手机平台。红9庄园app这里可以第一时间为大家收录关于区块链里边最新最值得关注的各种新闻资讯哦。这里也可以实时查看那各种类型的虚拟货币的价值的变化趋势。这里第一手的线上赚钱的最新最火的资讯你都不会错过。
蚂蚁帮	　　蚂蚁帮app是一款新上线的快手、抖音自动做任务赚钱平台，任务类型：点赞、关注、阅读、唤醒，平台app内置自动脚本，做任务类型、点赞、关注、阅读、唤醒，新人注册送5000金币，10000金币=1元，平台满1元就能提现，24小时内到账，每天可提现3次，邀请好友有20%收益提成。
淼润	　　淼润app是一款种水果赚钱软件。线上注册新人用户就可免费领取平台的种子，可以自由在线进行种植，利用空闲时间在线娱乐即可，玩法很简单，即可打发时间，还可轻松赚零花钱，可以邀请新人用户加入，并绑定个人邀请码，可以永久获取平台分红奖励，可以通过微信红包的形式进行奖励转出，感兴趣的用户可以进行下载！
CT挖矿	　　CT挖矿app是一款可以享受分红的挖矿赚钱软件，用户可以在CT挖矿app这里开启自动挖矿模式，通过系统自动运转，并且矿机可以提升等级，等级越高的矿机挖矿速度越快，每天只需要上线领取奖励即可，玩法简单！
蚂蚁M2	　　蚂蚁M2app是一款最新上线的大家都喜欢的一个线上赚钱的应用哦。在蚂蚁m2app这里大家赚钱的方式很懂，娱乐性质也很高，很适合大家放松的休息时光来这里赚钱，既能解乏放松紧绷的大脑也可以很好的线上关注学习自己想要领取的各种内容信息哦。当然线上警醒各种类型的操作都是非常靠谱的哦。
星火传媒	　　星火传媒app是一款最新推出的在线赚钱软件，在这款软件上，用户可以通过实名注册领取新人奖励，并且用户还可以在线邀请好友参与，不仅可以获得新人奖励，还可以在线领取额外奖励哦，从市场结构的角度来看，由于中国智能客服市场巨大的发展空间，因此，这款软件很有发展前景，你邀请的用户越多，那么你赚钱就越多哦。
ACOIN	　　COIN矿机app是一款手机挖矿赚钱的软件，新人用户注册成功，就可以获得免费的矿机，每天都可以通过矿机获得大量的奖励，它的操作特别的简单，一点难度都没有，邀请好友一起参加也可以获得奖励，可以通过直推来获取可观的收益，推广的人数越多，获取的收益就越高，还可以了解到最新的数字货币信息。
摩登魂兽	　　摩登魂兽APP是一款超级实用的手机软件，主要是针对手机在线区块链领养打造的便捷平台。在本款软件内是能够为小伙伴们带来四大种类的魂兽，可以选择自己喜欢的类型去饲养，不一样的分类为我们带来的收益都是不一样的，是需要我们认真去领养，带来的收益可以随时随地上线提现，为我们带来便捷，有需要的话快来下载摩登魂兽APP吧！
QuantBroker	　　QuantBroker是一款区块链交易所软件，利用这款软件用户可以随时查看到最新的区块链市场变化情况，随时可以在线进行投资交易，还有免费奖励礼包可以随时领取，软件不需要任何的投资，每天签到就有数字货币领取，可以在线随时进行投资，买卖没有限制，邀请好友注册使用可以获得额外奖励，还能享受团队分红，快来抓紧时间下载使用吧。
米菲云仓	　　米菲云仓app是一款十分好用的区块链赚钱平台，在这款软件上用户可以享受到新时代赚钱的趣味，用户只需要在线实名注册即可获得平台上的新人奖励，并且奖励十分丰厚哦。另外，用户还可以邀请好友一起参与，目前，这个平台采用团队推广模式，用户可以在线进行发展下线继续推广，获取更高的收益。平台没有任何门槛，实名注册即可参与。
UNT万通币	　　UNT万通币app是一个集高效买卖矿机、快速托管矿机、云算力服务、金融服务于一体的全球区块链矿业综合服务平台，UNT万通币app致力于数字金融与矿业的有机结合，是Canaan嘉楠耘智、InterHash算力互联的重要战略合作伙伴，目前自有Avalon阿瓦隆等主流矿机算力超过300P。
OEwallet	　　OEwallet钱包app是一款基于区块链进行数字货币交易网赚的软件，大量的区块链数据信息更新发布，用户可以在线掌握一手资源，通过OEwallet钱包app客户端还可以在线申请轻主节点，将区块链矩阵裂变流失的50%网赚收益获取，百分百的网赚收益，还有红包现金领取，赶快下载体验试试吧~
多团联盟	　　多团联盟app是一款拥有超多兼职任务的手赚平台，这里有各种各样赚钱的任务，每天都有大量红包奖励，用户随时随地上线都可以接单赚钱。经常看到小伙伴在找靠谱的网上赚钱平台，多团联盟app就很不错，大家可以来尝试下赚钱。新用户完成注册就送红包，这里任务非常轻松，佣金提现到账快，想要赚钱的朋友快来下载多团联盟app体验吧!
天宏生态	　　天宏生态app是一款全新上线的区块链网赚软件，
众品兼职	　　1、全新上线的手机兼职工作求职平台，汇集了海量优质的工作机会；
luck挖矿	　　luck挖矿提供给用户们的是一款非常不错的区块链投资平台，注册平台后是可以领取矿机使用的。提供给用户们的是一款专业的挖矿平台，这里的矿产资源十分丰富，很多挖矿模式提供，大家是可以自由选择的，并且还有投资知识可以在线学习。
环球联盟	　　环球联盟app中将会为你带来更多信息，你可以在这了解到更多区块链方面的内容，
bmcoin交易所	　　1、选择不同的区块链产品，它的投资机制也是会有区别的，实现掌握好规则更为重要。
梦幻农庄	梦幻农庄这款模拟养殖的软件玩法特别新颖，全新的界面，更吸引人，零投入，还有很多趣味任务，每天晚一些游戏就可以获得不错的收益，还有很多任务等你完成，还能和朋友一起赚钱，可以利用空余时间赚到额外的零花钱。
福气鼠	　　福气鼠赚钱app是一款全新的手机养鼠赚钱的软件，这个软件赚钱的方式特别的简单，没有任何的难度，只需要用户饲养老鼠，就可以获得大量丰富的奖励了，不同的老鼠带来的收益也是不一样的。
果树世界	　　果树世界app是一款类似趣树种树产果的农场游戏玩法的一个项目，
锦鲤矿场	　　锦鲤矿场正在空投，注册并通过实名认证，获得2000鱼群，团补，团队化推广!
幸运猫区块链	　　幸运猫区块链app是一款非常优质的手机软件，
天天嘉生渔场	　　天天嘉生渔场app是为用户提供安全可靠的赚钱平台，
多米生态	　　多米生态app即将上线,让打种树成为变现的技能；集合游戏+生活服务+商城购物+直播！无成本O撸，每天登陆就可赚钱。
圆梦圈	软件特色
区块幸福松鼠	　　松鼠的品种还是挺多的，用户可以挑选喜欢
硅谷区块鼠	　　能够进行养鼠赚钱的手机软件
欢乐发圈	　　专门为用户们提供在家就躺赚的服务
秒秒通	　　1、一级刷卡成功效率：实测刷卡成功率达到 97% 以上；
财管家	　　便捷管理支付宝、余额宝、蚂蚁花呗、京东白条、债券、基金、股票房产等资产流动，即时对接工行、农行、建行、招行和中国银行的卡等银行卡信息，一账通用，安全有保障。
挖矿猫	功能介绍
步行宝	　　步行宝DD一款为您准确记录每日运动走路步数的APP。
疯狂合成鸭子	　　疯狂合成鸭红包版的操作十分的简单便捷
鲸鱼记账	　　专业做记账就选鲸鱼记账！记账更省心，生活账本小助手！
淘推推	　　淘推推app是一个全民共享模式的一站式的购物推广赚钱的平台。在淘推推赚钱软件这里用户可以了解到最新的赚钱攻略资讯，轻松在家赚零花，淘推推app每天更新大量任务，用户可以在线领取，任务简单轻松，只需要阅读或者分享等即可轻松赚钱，用户只需要完成淘推推app的简单操作即可完成，并且用户还能够通过邀请好友来获得更多收益。
十二草集	软件特色
疯狂太郎	　　一款专门为用户们提供区块链养仓鼠赚钱
天赐竹盐	　　天赐竹盐app最新火爆上市的手机购物赚钱软件
金蝶微宝	　　金蝶微宝app是一款线上抢单赚钱平台，金蝶微宝app用户随时随地在线都是可以进行抢单，金蝶微宝app是不需要用户的任何投资的，完全实现了零投资，直接下载注册之后就可以开始使用了，而且平台里面有多种赚钱的方式，你可以随意在线进行挑选。
淘推宝	　　淘推宝app是一款非常热门的线上手机接单做任务赚钱软件平台。淘推宝app专为喜欢玩手机的用户打造的线上网赚平台，里面有很对丰富的任务资源，每个资源都有自己的价值，都是明码标价的，淘推宝app还会有任务的说明和操作的情况说明，淘推宝app帮助用户快速的获得收益，操作还是相当简单方便的，淘推宝也是很多朋友都非常喜欢的一款，并不需要任何的基础，直接在手机上就能完成了！
球球推推推	　　球球推推推红包版是一款很适合无聊时间玩也很解压的休闲小游戏。控制方式很简单的哦，在关卡中有很多的球球存在而你要操作吸铁石来收集这些球球，推动球球的前进在道路上收集其他更多的球球，根据你的表现收集的球球数量越多的话，最后的到的星星数量也就会越多！达到关卡要求的数量之后才能够开启下一关！
马场大亨红包版	　　马场大亨红包版是一款赛马题材的策略竞技游戏，马场大亨红包版游戏非常真实的模拟了现实中的赛马从培育到参加比赛的过程，逼真的3D游戏画面和马匹动作，以及细致的细节处理，给玩家带来最真实的赛马游戏体验！
全民乐赞	软件介绍
犀首	　　1、首次注册登录立马送奖励，转发被点击阅读一次计费，涨分好收益快;
匠子科技	　　匠子科技app是一款运动打卡赚钱的手机软件，这款匠子科技软件上有很多赚钱的任务，每天完成之后就能领取积分奖励，积分除了可以兑换红包外还能兑换不同的商品哦，匠子科技app赚钱方法简单，每天都能领取零花钱，通过打卡签到养成早起、喝水、自律等良好习惯，提高生活工作效率。
金粉世家	　　金粉世家福利赚钱app是一款全新的手机挖矿平台，做做传媒任务都能获取钻石福利。把千百万用户集于一个平台，没有风险，每天轻松赚收益，在金粉世家app这里，用户可以通过团队人数来壮大自己的手机值，金粉世家app也是用户赚取比特币的最佳区块链福利挖矿平台工具哦！
搜宝猫	　　搜宝猫app，我们很靠谱!
知书答礼	　　知书答礼app是一个免费注册就可以成为运营商的赚钱平台，用户身份可以边学习边参与答题赚奖学金，代理商身份则可以赚直推用户的20%消费额提成，还有很多其他的赚钱方式，上线注册即可赚取新人红包，在线拉新、答题学习知识、商城购物、推广引流均可赚取翻倍收益。
众鑫寻树	　　众鑫寻树app可以让玩家在游戏中体验经典消除玩法。全新的游戏内容和游戏风格，简单明了的游戏规则，独特的游戏设计，玩家在游戏中要不断挑战更多关卡，获取超多游戏奖励。每一道关卡都有不同的通关方式，玩家可以自由发挥吗，多多尝试。
吉客优品	　　吉客优品app为用户提供安全可靠的赚钱平台，吉客优品app每天都会更新大量的任务，吉客优品app用户可以选择喜欢的去完成，等级越高领取的任务也不一样，当然佣金会更丰富，随时都可以提现，让你轻松体验生活的乐趣。
花园连萌消红包版	　　花园连萌消红包版是一款轻松有趣的消除游戏，各种新鲜有趣的比赛都可以等你来解锁，在游戏的过程中玩家将学会各种紧张刺激的比赛，将画面中所有的东西通通都消除干净，每次通关都会获得相应的红包奖励，简单易上手的操作，一起加入挑战之中。
极速打字	　　极速打字app是一款以打字来赚钱的平台，平台上每天都会发布海量的任务，用户主要是将任务中的要求和文字输入在指定的文档里就算完成任务，操作十分简单，利用业余时间就能完成，没有任何风险和押金，赶快下载吧。
领跃传媒	　　领跃传媒app是一款只需将各大购物网赚的推广商品转发到朋友圈就可以赚钱的APP，佣金累积到一元钱就可以直接提取，需要分享的商品都是京东、淘宝、拼多多等著名购物平台上面的，所以来源绝对可靠，绝无三无产品，不会影响到大家的信誉和口碑。
易人帮	　　易人帮app玩法类似之前大火的众人帮，牛帮，趣闲赚等，这里每天都会发布一些悬赏任务，用户下载后自由挑选感兴趣的任务，接单完成就有奖励，针对新用户奖励超丰厚，作为一款长期赚钱的平台，每天都会有一些新鲜任务提供，你能想到的网赚类型这里基本偶读支持，包括社交平台点赞关注分享任务、注册、试玩app等任务哦~
荒野行动猛虎辅助	　　荒野行动猛虎辅助安卓为游戏带来自动挂机、一键瞄准、超级加速、锁血辅助、无限子弹等辅助功能，荒野行动猛虎辅助手机官网pc操作简单，轻松游戏。
微赞	　　微赞点赞赚钱app是一款非常好用的手机点赞赚钱软件。微赞app最新版本这里的单价都很不错，用户只需要根据要求完成点赞任务就能获得奖励，每天的收益赚的不少，这是一款主要是以点赞为主赚钱为主要形式的软件，主要是以抖音，快手，刷宝等各种短视频平台进行合作，超多的点赞任务可以领取，让其可以轻松的进行赚收益，快速的进行提现到账。
长江赞	长江赞app平台每天都会实时的发布一些任务，你随时都可以在线领取完成，同时长江赞app平台上的任务也是非常简单的，你随时都可以在线领取完成，两三分钟就可以完成一个任务，平台也会很好的保护你的账号隐私情况，可以放心使用，一天下来的收益还是很不错的，非常的适合宝妈和学生党们在空闲的时候赚零花钱。
99辅助平台	　　99辅助平台每天都会更新大量的兼职任务，可以根据你的兴趣，喜好进行接取，任务都很简单，汇集各种类型，如邀请新人用户，微信抢单，转发，分享，点赞，等等，都是可以赚取零花钱的，实时都在更新任务，自由接取！
赞客汇	软件特色
酒福宝	　　酒福宝app是一个以酒文化为特色的区块链互助盘。酒福宝app以区块链去中心化的优势，保障用户的权益，用户可以通过酒福宝app的微分去预约抢购各种酒来赚取收益，另外酒福宝app还有团队建立、建群奖励、推荐奖励、直推奖励等多种福利，通过注册酒福宝，您可以获得微型酒窖矿物，并且您可以轻松享受全球采矿盛宴。
红人部落	　　红人部落app是一款连接网红和品牌的服务性app，红人部落软件其中包含网红选品、网红服务，即网红商品供应链提供等功能。 红人部落app不获取用户位置以及手机隐私信息，保证用户的使用安全。
赚赚宝盒	　　1、非常多的任务都可以给大家分享，只要有时间都可以在线找到很多的一些任务。
STW星球文化	　　STW星球文化app是一款手机金融挖矿类的应用软件。星球文化app以各个星系为特色，用户通过抢购STW星球文化app的星系来获得收益，最大的收益来源还是做推广哦，。星球文化app收徒是有收益提成的，等级越高，享受的下级代数越多，提成也越高，轻松在线为您提供满意的挖矿服务，星球文化帮助用户快速挖矿赚钱哦！超多用户都能线上使用。
抖粉团	　　抖粉团app是一款可以帮助大家轻松赚钱的手机软件。抖粉团app受到了很多用户的喜爱，每天都可以手机上面领取任务，任务的类型非常的丰富，抖粉团app的玩法多多，你可以自己来选择比较喜欢的任务，直接手机上面操作就可以了，抖粉团app非常的方便，每天都可以在线领取任务，只要完成抖粉团app的任务就能有收益，轻轻松松手机挣钱。
蜂帮	　　蜂帮是一款学生、宝妈、上班族闲余必备手机赚钱利器，适合想利用闲余时间兼职赚钱的人群。
大趋势	　　大趋势app是一款非常专业的金融服务软件。大趋势炒股软件帮助为大家带来最新最全的各种金融市场行情以及讯息，大趋势app让大家能够更好的进行投资理财。大趋势app是一款经融理财服务类软件，我们为您提供投资主线逻辑，大趋势app基于大数据分析的仓位控制，盘中实时推送调仓建议，资深投顾的战法视频教程。大趋势为您提供盘前、盘中、盘后的全方位一体化服务。
刷宝互赞	　　刷宝互赞app是一款值得用户们来尝试一波的手机点赞互赞赚钱爱你的软件，刷宝互赞app和抖音快手等短视频平台通力合作，刷宝互赞app每天任务大厅内都有超多的悬赏任务，你可以一边刷着视频，一边随手点赞评论，就这么简单，佣金立马到你口袋。
百科大挑战	　　百科大挑战app是一款手机线上回答问题就可获得收益的平台，百科大挑战app每天时间地点的限制，适合人群广，老少皆宜，百科大挑战app不仅可以获得收益，还能丰富自己的知识！
赏多帮	　　赏多帮app是一款做悬赏任务赚钱软件。赏多帮app下载注册后有新人任务完成后可获得1.5元现金，超多类型悬赏任务包括下载app、账号注册、认证绑卡、电商有关、简单关注、简单转发、简单投票、简单采集、担保任务、社交分享，目前平台新上线任务还不多，大家趁早加入，早加入早受益。
网心云	　　网心云app是一款共享计算智能硬件，网心云app接入路由器、存储设备就可以将自己闲置的带宽、存储等资源贡献出来，网心科技将这些资源再进行整合加工，就成为了网心云分布式CDN服务。网心云APP用于管理网心云硬件设备，包含设备管理、收益管理等功能，主要服务于网心云用户。
券中社	　　券中社APPDD金融从业者都在这里。
富国富钱包	　　富国富钱包是富国基金的官方APP。闲钱存入富钱包，购买富国旗下基金费率尊享0.1折优惠，支持快速取现，单日快取额度1万，最快1秒到账。资金闭环，手机丢失也不用担心资金的安全。
急猫猫	　　急猫猫app是一款专门提供网赚任务的平台，大家可以利用生活中的所有碎片时间来急猫猫接单做任务，就能够充分的赚零花钱，而且急猫猫的收益不管多少都是可以属于自己的，并且急猫猫app绑定账户之后就能兑现，急猫猫app还无需有任何压力，因为时间上很是自由，根本没有限制，大家可以超省心的使用。
快手有赞	　　快手有赞是一个可以通过点赞获得高额利润的平台。也可以接收许多邀请消息，在快手有赞app看视频就可以赚钱。
闪购轻松赚	　　闪购轻松赚app是一款智能抢单平台系统，是属于国内首款云智能主机匹配订单类APP,
银河期货开户交易	　　银河期货开户交易app是一款期货交易平台，在线即可极速开户，让开户变得更加简单和轻松，自行根据系统的提示完成操作，简单几个步骤，轻松完成开户，还能够随时跟进开户的进度；应用是你的投资利器，在线即可获得关于投资的项目，时刻把握好投资的策略和方法，快速掌握到市场行情，让信息掌握在自己的手中，应用提供的信息和资讯值得信赖，是一个可靠的投资利器；根据精准行情，极速下单，闪电交易，让涨跌幅度都一清二楚，随时都能够将数据掌握在自己的手中，是专业的投资专家。
GXLG	　　gxlg交易所app致力于全新的打造，有多样的丰富社交方式，GXLG平台上不同的理财特性，合理的完成搭配和操作，参与到多样的管理之中，一站式的挖矿方式，各种的信息非常的充分，gxlg交易所带来了超多的乐趣，不同的区块链接，GXLG集合了有趣的赚钱项目，很好的完成提升，数字交易的方式，更好的进行搭配，组成一个新奇的体验玩法。
快转网	　　快转网app是一款非常受欢迎的手赚平台。快转网app为你提供丰富多样的资讯内容，快转网app涵盖生活、热点、养生、搞笑、科技、体育等20余个方面，老少皆宜。快转网app让你在闲暇时间既可以自阅打发时间，通过快转网app下载转发一篇文章到微信好友群、朋友圈，有了用户点击阅读浏览即可赚取收益!
91智投	　　91智投是一款专业的小额投资APP，
九洲云购	　　九洲云购app是一款相当不错的线上赚钱平台。非常多的任务将会出现在九洲云购app里面，你可以在九洲云购app得到更多信息，为你带来操作，九洲云购app让你可以快速获取收益，为你带来更多线上资源，这里面的任务数量比较多，将会为你带来更多服务，九洲云购app让你可以轻松得到信息，为你带来更多内容，很不错哦。
闪购抢单	　　闪购智能抢单平台系统，是属于国内首款云智能主机匹配订单类APP,
云雀通证LT	云雀通证LT正在空投，USDT需要使用ERC20以太坊网络地址创建，每日签到获得10，邀请好友获得更多，号称08/10上线交易所!
有钱快花	基本简介
威海商业银行	　　威海商业银行手机银行是一款专为威海地区人民打造的便捷生活的手机银行客户端，在该应用中用户可以轻松进行在线转账，帮助用户汇款。还可以查看理财收益，在线进行理财产品的购买。
一品接单	　　一品接单app，周发布任务量 10000+，设计(logo设计、vi设计等)，开发(网站开发、程序开发、游戏开发、APP开发等)，营销(网络营销、网络推广)，文案，法律咨询，装修设计海量任务订单，快来匹配适合您的任务啦！
约牛股票	　　DDD约牛会员，超级特权助你发现好股票DDD
平安E企宝	软件特色
陕西证券期货协会	　　协会的宗旨是：在国家对证券期货行业实行集体统一监管的前提下，进行证券期货业的自律管理;发挥地方政府与证券期货行业之间的桥梁作用;为会员提供服务，维护会员的合法权益和整体利益;维护证券期货业的正当竞争秩序，促进证券期货市场的公开、公平、公正，推动陕西证券期货场的健康稳定发展。协会的基本职能是：“自律、服务、传导”。
韭韭投研	韭韭投研app是中科院旗下爱科思瑞铂特（Xraybot）数据公司研发的一款为广大普通投资者服务的股票AI分析软件。韭韭投研app致力于为广大普通投资者打造简单易用、界面友好、且技术含量极高的新一代证券投资分析决策App应用。
晒了吗	　　晒了吗app是一款非常简单的手机赚钱软件，主要是通过试用来获取收益，用户注册每天接任务就能领取奖励，不需要任何投资，随时都可以接单赚钱，商品的种类还是很丰富的，让你轻松赚到零花钱，只要你有颜值，有很好的拍摄手段，那么你都可以进行试用赚钱，而且试用赚钱的额度还是很高的，每一单都可以轻松赚钱。
好看视频极速版	　　好看视频极速版app是一款看视频赚零花钱的软件，好看视频极速版app最新最热的视频都是超高清呈现给您，好看视频极速版app每天完成日常任务可以领取金币奖励，快来下载试试吧。
东方财富股票	　　东方财富APP（原东方财富网APP）又升级啦！我们为您提供全球股票行情，安全的全球交易，权威的资讯内容、互动的交流平台，是投资者的优选炒股软件。
快看点极速版	　　快看点极速版app是一款非常不错的短视频赚钱平台。主打竖屏剧场吗，还有短视频，让你看视频就可以赚钱，刷视频边赚钱，还可以邀请好友赚钱，更好的实现娱乐赚钱的目的，还是非常不错的平台的呢。喜欢刷视频赚钱的可以下载抖音极速版，微视，快手极速版，都可以邀请同一批好友赚钱，超多赚钱软件都可以在本站下载体验呢。
老板记账	　　老板记账app是一款专门为个体户、小企业主量身打造的财务记账软件。主要有记账数据录入、记账数据分析、数据同步和导出等功能。软件采用安卓平台当前最流行的kotlin语言编写，老板记账app使用安卓平台最流行的技术如room数据库技术、worker后台任务技术等。人性化的产品设计，让繁琐的账务管理变的简单。
基本面	　　基本面app致力于为广大投资爱好者提供多方面的选股决策建议，帮助投资者能够从中获取最新投资交易情报，不错过任何可投好时机；
京东银家	　　京东银家app是由京东金融推出的一款赚钱项目，用户们能够通过投入资金来获得收益奖励。推广邀请好友可以获得奖励金，存入本金理财也能获得比余额宝还高的收益！
bdex交易所	　　bdex交易所app是款比较实用的区块链挖矿平台，实时为用户提供最新最及时的数字资产交易服务，每个用户都能及时了解更多虚拟货币信息，火爆行情实时查看，更有银行级的交易保障服务可以享受，更多安全交易随时等你体验，不要错过啦。
Kraken	　　Kraken交易所手机版是一款好用的手机区块链货币交易软件，用户可以通过kraken交易所软件交易自己的数字资产，支持比特币、瑞波币、比特现金、以太坊、以太经典等货币的交易服务，交易安全，操作简单，感兴趣的用户快来下载吧！
火网交易所	　　火网交易平台app是一款在广大投资理财人士之间都非常火爆的一站式数字资产交易服务平台，采用了的是我们大家非常熟悉的区块链模式，实时与火币网相连，为每一位用户提供更好的投资理财服务，手机上就可以轻松获取最最新最精准的区块链币种行情动态，各种价格浮动以及走势行情一网打尽，所以想要获取一手最新业内信息的朋友，不妨来下载火网交易平台app吧，只需要在手机上实时注册登录，就可以发现海量最新一手的币类信息，你可以选择在线关注自己需要的币种，就可以轻松获取最新的信息啦！
长银消费金融	　　陕西长银消费金融有限公司是经中国银监会批准，由长安银行股份有限公司联合汇通信诚租赁有限公司、北京意德辰翔投资有限公司共同发起设立的全国性非银行金融机构，公司践行“普惠金融”理念，遵循“开放化的思路、差异化的定位、特色化的产品、科学化的风控、精细化的管理”发展方针，致力于打造全国优质的金融企业。
长安企业银行	　　长安企业银行app是一款针对企业使用的手机银行客户端，长安企业银行app围绕“高效、便捷、智能、安全”四大核心目标，操作简单，界面美观，为企业客户提供账户统一管理、移动审批、增值资讯、智能提醒等丰富功能，长安企业银行app让客户享受移动金融新体验。
泰惠收	　　泰惠收是泰隆银行自主研发的，为商户提供的聚合收款APP，商户可通过泰惠收享受泰隆银行提供的收款服务、金融服务及其他增值服务。
熊猫速汇	　　熊猫速汇app是一款非常不错的金融资讯服务，熊猫速汇app专为海外华人提供一个非常安全可靠的汇款服务，值得期待，真的很靠谱哦，让汇款可以和发红包一样简单，真的是非常的优质可靠，到账非常快，全年无休，24小时随时都可以轻松完成汇款，真的很方便，有需要的都可以来这里看看，这里各种各样的资讯，各种各样的信息都可以一键查询哦！
清徐艳阳天	基本简介
芒果淘金	　　芒果淘金APP是一款非常实用和强大的移动投资理财软件，8元投资为用户提供专业的理财投资服务。在芒果淘金app这里可以持续发现实时的行情资讯，观察市场行情，发现很多投资策略，还有优质的投资产品，稳健理财，感兴趣就来8元投资体验吧!
悬赏猫	　　悬赏猫app是一款手机赚钱app软件，在这里你可以做悬赏赚钱，赚得佣金可随时提现。在悬赏猫app你也可以发布悬赏任务，让千万用户体验你的产品!
利弗莫尔证券	利弗莫尔证券app主要为全球客户提供安全、合规的证券交易服务，利弗莫尔证券app实时港股Level-2行情数据直线连接港交所，并通过专线隧道极速传达至客户。
掌上赚钱	　　掌上赚钱app是为有闲余时间的用户提供的掌上赚钱助手，掌上赚钱app里提供了很多简单赚钱的任务，掌上赚钱app操作简单，可以轻松上手，而且获得的收益比较的可观，可以轻松提现!
携程金融	　　携程金融app是携程金融官方研发的一个针对金融服务的应用，基于多年自主研发积累的大数据风险控制能力，融合包括银行、互联网消费金融等多方优势，为携程网、去哪儿网以及其他互联网用户提供分期付、借现金、联名信用卡、程信分等相关服务。
度小满金融	　　度小满金融是一款由百度旗下度小满金融打造的全新贷款理财类产品，为广大用户提供最优质的贷款金融服务，包括消费贷款，企业贷款等等多种贷款类别，贷款额度高，贷款利息低，是用户又一款必备的贷款神器。
开金中心	　　开金中心app是一款值得信赖的p2p理财平台，开金中心app依靠强大的风控体系为用户带来安全可靠的理财产品，每日热门推荐不断更新，在线交易资金由第三方担保，个人交易明细及收益情况详细显示。
陆国际	　　陆国际app是一款非常不错的手机理财软件，在这里有超级多的理财产品供用户选择，并且还可以即时看到自己理财产品的收益情况，一键提现，方便快捷！陆国际致力于将平安集团和陆金所在互联网金融和财富科技领域所积累的丰富经验和各类创新带向全球，在健全的风险管控体系为基础上，为全球投资者提供安全、高效、专业的在线财富管理服务。
新会农商银行	　　新会农商银行手机银行是新会农商银行为Android、iPhone、Windows Phone平台手机用户提供账户管理、转账汇款、自助缴费、理财投资、循环贷 款、积分兑换等金融服务的电子银行业务。
约牛财经	　　约牛财经app是一款专业的财经炒股软件，约牛财经app股民在线活跃度高，股市投资内容丰富，约牛财经app包括投顾观点资讯、牛金黄金知识，名师股票投资观点。由约牛财经app平台深度挖掘业内信息，甄别筛选出对投资者最有价值的资讯信息，提高用户投资效率、提升用户体验，实现价值信息与投资者需求的匹配，约牛财经app旨在为用户带来个性化、专业化的资讯数据服务。同时，约牛财经app还整合了约投顾、约牛决策分析系统、操盘内线、牛金黄金等一系列实用的投资咨询产品，致力帮助更多用户学会科学投资，以达到财富增值的目的。
朝阳智投	　　朝阳智投APP(66966.cn)，专注线上投顾服务，智能工具+人工服务，解决一亿股民炒股需求。
新客驾到	功能介绍
威高蓝海银行	　　蓝海银行app经中国银监会批准设立，持有银行牌照，秉承“科技金融，连接你我”的使命，致力为客户提供一站式的聚合金融服务，打造轻资本、交易型、类互联网化银行。
银行业统一支付	　　中国银联推出银行业统一APP（云闪付）。云闪付APP是各银行和中国银联共建的移动支付统一服务入口，将各大银行卡集为一体，在线充值缴费、转账汇款、充值等方便快捷，支持线上线下全生态移动支付，覆盖日常生活的重要支付场景，提供全面的银行卡跨行账户特色服务。
富民融通	软件特色
充电挖矿福利	　　充电挖矿福利app是一款全网首发5G手机充电挖矿赚钱软件，可以区块链云端挖矿、手机充电挖矿、推广好友享受额外奖励，赚钱速度特别快，就是这么的简单快捷。还可以根据任务赚钱，看视频、做任务、签到、打卡、邀请其他的好友等，都能够非常轻松的赚钱，就是这么的简单。
试客管家	　　试客管家app是一款非常火爆的网赚软件，试客管家软件主要是试玩新游戏、新应用还获取收益，用户每天上线领取试玩任务，点击完成就能轻松赚钱，还能提前享受新游戏带来的乐趣，真正的无任何投入要求，做任务简单无比、轻松无比、收益无比高，错过就太可惜。
动物王国区块链	　　动物王国区块链app是一款赚钱软件。动物王国app更好的结合区块链技术都在全新赚钱模式，你可以使用软件更好的进行各种动物饲养赚钱，软件具有海量小动物，各种类型一应俱全，各类奖励应有尽有，你可以更好的进行挑选，并且软件还可以随时随地进行提现，更好的轻松赚钱。
橘子树交易所	　　橘子树交易所app是一款最新推出的区块链交易软件，这款软件不需要用户进行任何的投资，现在正在大量空头虚拟币，用户只要注册登录完成实名认证就可以免费获取到大量的虚拟币奖励，而且用户的等级还能不断提升，需要通过邀请好友来扩大自己的团队提升自己的等级，等级越高获得的奖励也就越丰厚，交易是没有任何要求限制的，一枚币也能起售，但是目前的市场价格不是很稳定，需要用户时刻关注及时进行交易。
大航海家	　　大航海家区块链app是一款区块链的经营赚钱手游。这个大航海家游戏中你将会扮演一支船队的船长，对多个海岛进行开采资源，并且收为己用。事实上，这就是在赚取赏金，随着你的船只越来越多，开采的资源越来越多，进行的贸易也越来越频繁，你所获得的赏金也会越来越多！
益民otc	　　益民otc是一款非常棒的挖矿赚钱软件，软件功能强大，操作简单，用户随时可以在这里进行挖矿赚钱。软件每天都会更新最新资讯，并且每天都会有各种免费活动，用户可以参与活动免费学习赚钱知识。软件没什么门槛，只要你有手机就能轻松赚钱。
星座区域	　　星座区域app是一款非常有创意的手机赚钱软件，这款星座区域软件玩法非常简单，用户注册登录后进行新年预约，然后预约成功后可以点击收集，每天都可以收集超多的虚拟币奖励，这些奖励都能够直接用作交易兑现，没有任何的要求限制，收集失败会免费退还给用户微分，每一个订单在这里都能随时查询到，还可以邀请好友一起赚钱。
互易猴	　　互易猴app是一款游戏模式的赚钱软件，这块软件玩法简单，可以为用户带来很高的收益，而且这些收益都是实时到账的，没有任何的延迟，随时随地都可以进行交易，交易数量没有限制，新用户注册登录就送免费的小猴子，用户需要在规定时间内抢到猴子进行饲养，饲养成功后就可以进行交易，并且还可以进行推广，获得更多的推广奖励。
吉祥奥运	　　吉祥奥运app是一款为用户提供手机多种任务赚钱的服务软件，这款软件里面的为用户提供了多种不同类型的吉祥物，这些吉祥物吉祥物为用户带来的收益是不一样的，用户可以根据自己的实际情况进行领养，同时用户还可以邀请好友来一起赚钱，平台的提现到账速度也比较快！
BDB区块链	　　BDB区块链平台app官方版是一款用于区块链投资的手机应用，这里为广大投资者带来了一个更为专业可靠的手机在线投资服务平台，提供了全面的区块链数字货币产品，专业的交易市场功能服务，便于广大投资者轻松快速的在平台上进行操作交易，更全面的市场的数据，用户可以直观进行观察和分析，便于掌握更佳的交易机会，获得更好的投资汇报。
福牌摇钱树红包版	　　福牌摇钱树红包版是一款趣味性的种植赚钱软件。每天按时完成简单的任务，可以不断的升级你的树苗，每提升一个等级，你的收益也会相应的大大提升。登录游戏完成签到，会有许多的金币奖励，你可以进行各种升级，并解锁更多的福牌，福牌可以获得一定的福气值，这是非常重要的。任何人都可以参与进来，能够赚取一些小红包。
兔儿之力	　　兔儿之力app是全新上线的看广告赚钱平台，观看的广告越多可以获得的收益也就越多，但是看广告也是有一定的要求的，广告是有规定的时间，观看的中途是不能退出的，需要观看完了才可以退出，这样才可以获得收益，还是非常简单的哦。
Sitkoin	　　Sitkoin软件是一款最新的手机赚钱的软件，在这个区块链里，用户可以进行数字货币的交易，每天都有专业的人士进行安全的维护，不会出现任何的问题，另外用户还可以了解到最新的货币资讯与交易的行情，帮助用户随时了解最新的区块链数字货币行情和走势，让用户可以更好的进行投资，赚取更多的收益，非常好用！
蚁蜂	　　蚁蜂app是一款专门的接单赚钱平台。享受到更加有趣的模式，蚁蜂app每天超多的网赚小任务不断的发放，都是源源不断更新的，24小时给大家带来更多的精彩，而且类型多种多样，收益也是相当丰厚的，手指动一动基本上都可以赚到钱啦，可以实时满足大家的需求。
兔兔天堂	　　兔兔天堂app是一个领养兔子赚钱的平台，多种类兔子可以选择，选购之后就可以进行养殖啦，同时也是在赚取收益，然后也可以推广收徒，发展的下级越多，推广收益越多，随时可以提现。
平安车E通	　　平安车E通app是一款来自中国平安的手机客户端应用，平安车E通app专为二手车经销商打造，平安车E通app提供日常的本店车辆库存管理、客户管理、经营报表以及办理车辆贷款、帮客户办理车辆贷款服务，平安车E通app旨在替代现在线下传统的原始人脑记忆及纸质化的车上库存管理方式，打造最专业的二手车贷款金融服务平台，为经销商提供便利。
罗塔未来岛	　　罗塔未来岛app是一个以认购赚钱的平台，以工厂为主题特色，用户认购的就是各种类型的工厂，现在注册就送20能源，支持转增，因此用户可以转增出去，也可以接受他人的转增，能源是变现依据，用户参加认购就能在线赚钱，没有复杂的任务要求。
兜兜鼠	　　兜兜鼠app是一款通过推广来赚取收益的手机购物软件。用户只需要将商品链接分享给好友，只要好友点击进去就可以获得收益，邀请更多的好友发展成自己的下线可以赚取更多的收益，不同的等成绩等级获得的收益也是各不相同的，平台的运行非常稳定，每天签到还有额外的收益可以领取。
未来国度	　　未来国度app是一款全新上线的区块链赚钱软件。未来国度区块链app有着新颖的玩法，并且门槛非常低，赚钱方式也有很多种，未来国度app帮你轻松实现点对点扶持赚钱，当天赚到的收益立马就能体现到账，绝不拖拉，感兴趣的话快来下载试试！
卜艾阅读	　　卜艾阅读app是一款非常靠谱的阅读赚钱软件。卜艾阅读app为大家提供超多热门新闻在线推送，海量资源分享即可赚取佣金，随时收益看的见，频道分类便捷，更多佣金金额等你来玩，天天任务不断，零花钱轻松入手，阅读就能够快速的在这里产生收益的，而且这里的阅读任务都是比较简单没有什么特别的难度，完成起来非常的方便，而且在这里收益也是非常高的。
区块虎	　　区块虎app是一个集区块链宠物+社交，养成+交易平台。
趣享游	　　趣享游app是一款全新上线的试玩赚钱软件，只需要利用空闲的时间在这里试玩游戏就可以赚到收益，每天都会发布大量的试玩任务，随时都可以做任务赚钱，享受有趣的赚钱方式，喜欢趣享游app的朋友快来点击下载吧！
圣斗士星矢	　　圣斗士星矢app是一款全新的手机赚钱的软件，这个圣斗士星矢app与圣斗士星矢相结合，它的赚钱方式特别的简单，用户只需要招募圣斗士，就可以获得大量的奖励，用户只需在线动动手指就能轻松赚钱。同时赚钱过程中无需用户有任何风险投资，方便用户随时都能进行使用赚钱。
puc token	　　puc token区块链app是一款帮助用户追求梦想的手机区块链挖矿应用工具，新人登录本挖矿平台就赠送矿机带礼包一份。线上，我们也是非常真诚的邀请您与我们一同参与各种挖矿任务，一起在puc token平台创造出属于我们自己的共享区块链财富价值，在这里，让我们一起创造奇迹吧！一起挖矿赚钱吧！
挑战无敌答题王红包版	　　挑战无敌答题王是一款十分考验玩家头脑的休闲益智答题闯关类手机游戏，在其中会有着超多种类的知识问答来等待着玩家的选择，考验你的智力与反应力。在一种类型的关卡模式中去尽情的享受答题的乐趣吧！挑战更多的游戏模式！每天还有免费的抽奖次数，挑战智力和知识的问答。想要体验这份乐趣的玩家就快来进入游戏中去答题收获更多奖励吧！
UBICLUB	　　UBICLUB是一款全新的手机区块链赚钱的软件，在这里用户可以通过挖矿获得大量的奖励，也可以在这里进行数字货币的交易，UBICLUB通过汇总全球数字货币交易所的币种和交易数据，进行多维度、全方位的挖掘和分析，将最有价值的信息传递给用户。我们始终如一，“为行情数据而生”！
兼客点赞	　　兼客点赞app是一个通过接单点赞任务的赚钱软件。这款软件主要的赚钱方式就是通过大家去刷视频点赞或者在这里点赞开始赚钱哦，很多不错的线上兼职赚钱内容都会在这里为你快速的推荐到的，而且在这里赚钱非常的简单方便，没有什么特殊的地方，更多赚钱内容都会为你推荐。
BGOEX	　　BGOEX交易所app是一款非常安全可靠的交易所平台。BGOEX平台会很好的保护你的交易隐私情况，你还可以邀请好友加入平台，也是有一定的收益可以获取的，平台上还有许多的任务可以领取完成，都是非常简单的，用户很快就可以完成的，轻轻松松就能赚到不少的零花钱哦。
友刷	　　友刷app，是卡友支付服务有限公司的一款移动收款应用。友刷通用版主要满足商户随时随地收款，并为用户提供多种支付方式，如刷卡支付、扫码支付等。且友刷手机版的每笔交易结算款都可以快速结算到商户结算卡，资金安全0风险。
全民遛狗分红狗	　　全民遛狗分红狗app是一款超级有趣的养殖分红赚钱平台，操作简单，零门槛，适合所有人使用，平台里面还有许多的任务可以领取完成，平台上的任务都是非常简单的，用户随时都可以在线领取完成，也是有一定的收益可以获取的，用户一天下来的收益还是很不错的哦。
风启打字	　　风启打字app是一款非常实用的手机赚钱软件，软件里面有非常多的打字任务，用户每天只需要线上打字就能赚钱，操作轻松，时间自由，不需要任何押金，在家就能赚钱，这款风启打字app提供的不止打字赚钱这一个项目，还有签到，抽奖，商店等不同玩法，金币就可以兑换红包了。
银河矿工	　　银河矿工app是一款专门为用户们打造一个全新的手机挖矿赚钱平台。银河矿工app挖矿赚钱是能够进行区块链挖矿的网赚类产品，收益还是很激进的，只要用户使用就能够获得收益，使用的越多收益也会相应的多一些，多玩多得哦，赶紧试试吧！
微势力	　　微势力app是一款简单的赚钱平台。微势力app这里有海量的任务供用户完成，佣金还是蛮不错的，包括推广、关注、调查问卷等，更新非常及时，注册不需要任何投资，随时都可以参与赚钱，邀请好友也能获得永久分红，随时都可以进行提现，无需手续费，让你轻松赚到零花钱。
ETHAT	　　ETHAT云矿机app是一款矿机模式的区块链软件，现在注册就送矿机，只要点击挖矿就会自动开始为用户挖取矿币了，不需要任何的投资，新用户可以获得一台微型矿机，连续签到七天可以再获得一台矿机，连续签到15天后可以获得一台大型矿机，每天都能登陆领取矿币，随时可以交易没有限制，收益非常丰厚。
以太房	　　以太房app是一款轻松为用户对数字资产进行理财，专为用户带来安全可靠的区块链收益投资赚钱渠道。在这里，用户可以实名认证各种区块链房屋，一键采购交易各种房屋的价格信息，然后进行升级，并且用户每日还能领取各种房屋所产生的区块链数字奖励，以及海量的房币财富资源价值体系。
健康时代	　　健康时代app是一款推广赚钱平台，这里每天都会更新大量的任务，奖励还是蛮不错的，推广人数越多收益也就越高，每天签到也有额外的奖励，不需要任何投资，提现记录也可以实时查看，随时都可以进行兑现，而且不需要手续费，不用担心赚不到来获取，喜欢的朋友千万不要错过。
渔民集市	　　渔民集市app是一款手机赚钱应用软件。渔民集市app是一款全新网赚模式，为用户带来了通过养鱼就可以赚取收益的功能。平台上还可以邀请好友一起加入赚钱，这样所获得的收益会更多。并且平台有保障，用户可以放心使用日收益非常丰厚。
蜂蜜GO	　　蜂蜜GOapp是一款专注于旅行服务的品牌产品，以区块链技术为基础，打造基于通证经济的跨境旅行互助社区，提供更加优质、便捷、安全的海外旅行服务，并且利用社区海外影响力，弘扬中华文化，树立民族自信。用户们只需要在线购买自己所需的商品，到了一定数量后就会获得平台的返佣，而且在这里买东西还能享受优惠，让你买到便宜的东西也能轻松赚钱。
赞吧	　　赞吧app是一款很不错的赚钱软件，这款赞吧app是通过点击广告来赚取收益的，当然啦！必须是有效的点赞才能赚到钱，只需要动一动手指就能轻松赚钱，这么好的事情怎么可以错过呢？赶紧前来下载这款赞吧app吧！
Fmall	　　Fmall交易所app是一款全新上市的虚拟数字交易中心，在Fmall这里用户可以感受到全新的区块链玩法和规则，不需要任何投入，并且用户承担的风险非常小，每天按时签到也能获得相应的Fmall币，通过矿机自动产生来获取收益！
亚太文旅联盟	　　亚太文旅联盟app是一款全新上线的区块链赚钱软件。亚太文旅联盟APT为广大用户提供更加便捷的挖矿赚钱方式，形势非常不错，并且还有许多专业的区块链数字货币交易信息可以了解，用户可以更加轻松的赚到钱，喜欢的话快来下载！
MACE矿业联盟	　　MACE矿业联盟app是一款非常不错的手机赚钱软件，用户可以在MACE矿业联盟挖矿获得收益，灵活度非常高，无论是什么时候都可以操作，想要体验轻松赚钱的用户不要错过哦~赶紧前来点击下载吧！
区块word	　　区块word app是一款最新推出的区块链资讯软件，在区块word软件中您可以阅读到海量最新最热的虚拟货币资讯，让您实时了解区块链市场行情，你想要的交易互动服务在这里都能被轻松的满足，这里不仅有最新的新闻和信息块链技术服务，也支持世界各地的所有数字货币交易，最新的各种最新的新闻资讯服务为你及时的推送，用户只需要注册就会为你送新手礼物，了解最新的区块链策略信息，服务体验超棒。
速汇宝	　　速汇宝app是一款新款智能抢单平台应用。速汇宝抢单APP采用国际服务器，抢单速度快、安全稳定防封，一部手机即可轻松实现智能匹配订单接单赚钱，还可在线查询团队收益，轻松接单赚取佣金。
番茄币圈	　　番茄币圈app是一款专注于区块链的资讯服务软件，用户可以使用这款软件实时的查看最新的行情动态，并支持智能交易，及时的推送交易提醒。
万码接码平台	　　万码接码app是一款非常棒的接码赚钱平台，有赚钱想法的用户可以早点上车，全新的赚钱模式，高达70%分润等你来抢，你要做的事情很简单，只要将自身所接收到的验证码进行填写，就可以领取到商家派发的任务酬金了！平台的任务没有数量限制、到账速度也很快，大家缺钱的时候，可以随时来接码赚钱用，赶快来下载吧！
浙江民泰商业银行	　　民泰银行手机银行是通过移动网络开展的一项新的金融服务。您可以随时随地地享受到手机银行提供的各项服务，为您免去了柜面办理业务长时间等待，手续繁琐的烦恼，也为您免去了使用网银需携带电脑的不便。
众包自动抢单	　　2020众包自动抢单软件是一个合作各大的平台，提供实时的众包任务，有网赚的任务，也有同城的配送服务。大家闲碎的时间自由的接单做众包的兼职的综合平台。让你在线极速的抢单，一站式的做任务的综合软件。兼职资源不断的更新，闲碎时间都可以做众包任务的软件！
向前金服	　　向前金服是北京捷越联合信息咨询有限公司全资子公司-北京捷越联合金融信息服务有限公司(简称“捷越金服”)在2016年推出的一款“出借神器”。
数金链	数金链olo交易是在线交易数字货币，稳妥的投资矿机的综合数字交易平台。支持全球的各类数字货币交易，还有实时的内情提供。在矿机商城里面进行顾投，一站式的交易的综合软件。
吉利灵宠	　　吉利灵宠app是一款模拟养成宠物赚钱的软件！下载吉利灵宠app就送现金红包！萌宠们举止动作生动有趣，令人爱不释手！你要带着你的萌宠互动、逛街、玩小游戏，还可以为你的萌宠打造个性化的家，创造出属于自己的梦幻家园！
云宠宝贝	云宠宝贝为用户提供安全可靠的赚钱平台，每天在线抢购宠物就能持续获得收益，随时都可以在线参与赚钱项目，种类还是很丰富的，花很少的时间就能赚到零花钱，轻松体验养宠的乐趣。
中信建投证券	　　中信建投手机APP是中信建投证券官方为广大投资者倾力打造的新时代理财神器！致力于为广大交易者提供极速、安全、优质、全面的服务，实时推送重大信息，独家资讯限时免费，投资交易极速搞定等一站式投资理财服务，做您新时代的理财贴身管家。
矿工鱼	软件介绍
欢乐动物园	　　在欢乐动物园app中从零开始经营你的动物园赚钱吧！
龙之九子	　　龙之九子app是一款最新推出的在线赚钱软件，在这款龙之九子软件上，用户可以在线养殖恐龙，每种恐龙的生活习惯有很大的不同。您需要制定最佳的养殖策略。游戏风格充满了浓郁的卡通气息，为玩家提供了超强的视觉感受。此外，您可以在购物中心购买功能强大且实用的商品，帮助用户在线养殖，你的恐龙越多，你的收益就越高哦。
御龙师	　　御龙师app是一款超好用的手机养殖赚钱软件。用户每天登陆签到是可以获得平台的金币奖励的，新用户注册登录就可以获得平台赠送的龙作为奖励，然后不断的饲养来获取收益，还可以将同等级的龙进行合成升级，等级越高收益也就越多，还可以分享给自己的好友也是有奖励可以获取的，平台也支持离线收益，你不完成平台上的任务也是有收益的哦。
远古神龙	　　远古神龙是一款为用户打造的养殖赚钱App。远古神龙app为您提供了超级好玩的养殖赚钱哦，在这里您可以得到平台提供的小龙进行饲养哦，这些小龙都是非常的可爱的，能够让您看有眼就会喜欢上哦，此外，将这些小龙喂养一段时间后，就可以为您带来收益了哦，而这些收益还很丰厚的哦，此外，您还可以给小龙升级哦！
小鱼平台	　　小鱼平台app是一款以接受验证码来赚钱的手机赚钱工具应用，小鱼平台上有很多不同的接码任务供大家去选择，随时接单轻松赚钱，大家都能很容易就赚到钱。当然还有推广赚钱方式，只要你认识的朋友多，这种方法同样很容易赚到钱，还在等什么呢，快来下载赚钱吧！
卡小邦	　　卡小邦app是一个类似卡银家的信用卡网申推广赚钱平台，当前注册为合伙人为，即可免费获赠10元现金，需要简单的实名认证，填写信息即可，不上传，不刷脸，不要钱。然后参与抢红包活动，可以抽到5-100元，不过一般都是5元，所以总共15元，可直接提现银行卡！
合并小小龙红包版	　　合并小小龙红包版是一款全新上线的手机小龙龙合成赚钱应用软件。合并小龙龙app上有多种关卡，每一关都有合成小龙必须的材料，每次通关就可以成功合成一只更高级的小龙，还能领取现金红包奖励。系统为用户提供了收集不同种类小龙的任务，每次完成都有大量佣金奖励，关卡十分丰富，无限任务挑战。
功夫小龙虾红包版	　　功夫小龙虾app是一款全新上线的赚钱软件，用户只需要在规定的时间内抢购能够带来的收益的宠物就可以了，每天自动产出收益，随时都可以进行提现，不用多复杂的操作，轻轻松松开启赚钱模式，操作非常的简单，用户在线抢购龙虾就可以了，不同类型的龙虾为你带来的收益也是不一样的，每天登陆签到也是有一定的红包奖励给你的哦。
玛丽悬赏	　　玛丽悬赏平台虽然是新平台，但是玛丽悬赏平台上线前就对接了大量任务方，所以不会出现上线就缺任务的情况，跟两大老牌旗鼓相当。
星聚宝	　　星聚宝app是一款可以网上兼职赚钱的软件。随着科技的发展，互联网遍布世界各地，我们几乎离不开手机和网络，当然我们也能通过手机来赚钱，这款软件就是可以在网上接任务完成之后就可以获得酬劳，赚钱还是很简单的，想赚点小钱的朋友可以来下载星聚宝app哟，不会失望的。
互赢托管	　　互赢托管app是一个托管微信号和挂机赚钱的平台，1元即可提现秒到账，可以通过微信挂机或阅读文章赚钱，一个微信号每天能赚1~3元，可以挂多个账号。
TGC英雄汇	　　注册需通过推荐人二维码或链接免费注册账户，注册登录后需要实名认证，准确填写好会员信息及收款方式（最少绑定两个）。凡是注册账户免费送10金币，激活账户需30金币，首次充值20元送20金币。内测期间限制注册500名会员!
微帮乐	　　微帮乐抢单让用户们体验最新一个抢单赚钱的平台，更多赚佣金的收益方式免费更新，平台每天发布超多的兼职赚钱的任务，一键完成收获更多的福利新体验，随时都可以赚更多的好礼，今日带给大家福利内容！
小福星	小福星平台上每天给大家更新的任务都是海量的，每个任务的收益不一样，但是都非常的简单就可以完成，有兴趣的话可以来下载看看！
小白象	　　小白象赚钱app注册就有单。24小时立返平台，小白象接单app可绑3个号，一号一天两单。小白象app特别刺激新颖好玩的试玩赚钱手机应用，轻松享受精彩纷呈的赚钱体验。
小马驹区块链	软件特色
聚金来	　　聚金来app是一款能做任务赚取收益的软件，在聚金来app上有很多的任务，你可以轻松的完成任务，获得更多的收益，聚金来app操作十分的简单。
小红鱼	　　小红鱼app是一个转发分享新闻资讯赚现金的软件。小红鱼app能看新闻转发还能赚零钱。文章都是精选细挑，精益求精，非常耐看，而且更新的速度也是非常快的。这几天都转发不少文章也看有钱进帐，但是文章发给个人是没有钱的，您需要发到微信朋友圈或是微信群里，文章需要阅读完，打开就关闭是没有计费的。红鱼赚app的搜索功能已全面升级，大家可根据关键词搜索想要的文章。
竹帮帮	　　竹帮帮app是一款全新的任务抢单赚钱软件，竹帮帮app里为大家提供了非常多的任务，竹帮帮app让你们都能在这里轻松的找到自己喜欢兼职，短短几分钟就能完成，佣金火速立马到账，有需要的可以来下载。
小猴子乐园	　　小猴子乐园接单平台是一款非常专业的手机接单赚钱软件。小猴子乐园app提供非常多的接单赚钱任务，操作简单易懂，个性化的手机操作界面，稳定的计划赚钱方式，随时都能登录立马领取现金红包，有些任务是需要抢，只要你够勤，随时都能赚到钱，收益看的见。
火星译客	　　火星译客app是一款非常棒的手机翻译赚钱软件，火星译客app里面提供非常多的翻译任务，火星译客app用户可以领取任务线上翻译，不同的任务价格不一样，操作简单，安全靠谱，外语好又想赚钱的朋友赶紧来体验吧！
聚鑫汇	　　聚鑫汇app是一款近期上线的手机软件，聚鑫汇app主要就是能够为我们带来海量任务打造的平台。在聚鑫汇app内能够每天为我们发布最新的优质任务类型，都是可以直接在手机上完成的，赚钱任务的方式也都是非常简单操作的，我们可以和小伙伴们一起在手机上共同赚钱，没有限制。
益民宝	　　益民宝app是一款主要通过推广拉新和领取任务进行赚钱的手机软件，益民宝app用户使用该软件通过讲商城中商品推广有用户点击你的推广链接进行购买你将可以赚取其中的利润，同时使用该软件你还可以领取不同的拉新任务进行赚钱，并且每天这些任务每天都是不一样的哦，任务简单容易完成。
小天共享	　　小天共享app是一款非常多玩法的网赚游戏平台，在小天共享app上面用户无需任何的投入直接就可以进行赚钱，小天共享app玩家可以选择合适自己的来完成任务就可以获得佣金了，非常的简单！
欢乐鼠小弟	　　欢乐鼠小弟红包版专门提供养鼠赚钱
小鱼试看	　　每天都可以在线领取丰富的任务好礼
物联云矿	　　物联云矿app是一款最近超火的手机挖矿赚钱平台，
切水果贼6	　　切水果贼6游戏是一款经典的切水果游戏，切水果的游戏一向是休闲类游戏中的王者，切水果贼6红包版玩家操纵着飞刀来切水果，但是玩家要避开炸弹，玩家的飞刀一旦切刀炸弹，炸弹爆炸游戏结束。
水果蜜源	　　水果蜜源app是一款真实靠谱的赚钱软件，你可以使用软件更好的随时随地轻松赚钱，
大闹果果山	　　大闹果果山app是一款收益丰厚的果树种植赚钱软件，有了这款软件，大家就可以通过种植虚拟果树的方式进行赚钱啦！果树需要每天进行浇水才能购快速成长哟，你需要完成平台内的趣味小任务，才能够累积到一定数量的水滴哟，所以大家一定要每天按时签到打卡，在线互动，才能将收益最大化，最终实现快速赚钱呢！
每日水果	　　每日水果app是一款种植赚钱的手机软件
西银惠付	　　西银惠付，聚合线下支付平台是我行基于与微信、支付宝、银联等平台直连而开展的一项互联网创新业务。客户在线下实体商户进行消费时，可选择扫描商户的收款二维码或被商户扫描其手机应用中的付款二维码完成消费交易。我行现已实现商户端微信、支付宝、银联收款三码合一。
云种茶	　　云种茶app是一款非常好用的手机区块链种植赚钱应用软件。云种茶app上，用户可以通过种植茶叶来获得一定的收益，只要完成平台任务就可以获得茶叶种子，用户只需点击几下就能种植成功，需要用户不断培育自己的茶叶。茶叶成熟后就可以采摘了，根据茶叶的种类来计算价格，使你可以体验种茶赚钱的乐趣！
种花得宝	　　种花得宝红包版是一款支持微信登录的种植赚钱类软件。种花得宝app这里拥有超多品种的花种，也拥有超多的种花任务，用户实名注册上线就送0.3元红包，进入种花得宝app后，就可以领取种子种植赚钱，还能在线分享推广好友一起种花，舒适休闲，享受永久的分红收益，网赚不断~
种菜领红包	　　种菜领红包的游戏是一种种植蔬菜领红包赚钱模式应用，
爱财猴	　　每天来签到就会赠送一些加速成长的道具
财神云	　　财神云app是一款在线抢单、接单的试玩和做任务赚钱平台。财神云app这里的任务类型和单子数量非常多，不但可以第一时间自动帮你接单，还能选择性的完成，每个单子都有详细的教程和佣金可以查看，邀请好友加入还能获得丰厚的福利！
欢喜招财犬	欢喜招财犬红包版一款十分有意思的养狗赚钱应用软件。开始之后，你可以带着自己的狗狗去外地旅行，在前往世界各地的途中提升等级合成更稀有的品种，用户解锁新的狗狗就能领取额外的现金红包奖励，更有就会获得分红犬，上线就可以直接领取现金分红，躺着就能有钱赚。
国泰君安君弘	　　国泰君安君弘app是由国泰君安证券打造的一款官方手机端证券行情交易软件，国泰君安君弘手机版智能分析个股表现，洞悉资金动向；多种策略帮你盯盘，止盈止损，反弹买入，回落卖出，就是这么牛。
财富小镇	　　财富小镇是西部利得的一个活动，
蚂蚁外快	　　蚂蚁外快APP是一款一款全新上线的微信加人拉群赚钱软件，轻轻松松一天好几十！蚂蚁外快app只需要加加好友就有钱，加一个好友1元，满15人之后可以完成拉群任务佣金更高，2元起能申请提现，第二天早上到账，审核很快！蚂蚁外快，简简单单，每日赚点外快！
快引	　　快引是什么，为什么暴利
快乐招财犬	　　快乐招财犬app是一款模拟养殖赚钱的平台，通过虚拟养殖狗狗获得收益，现在实名注册就可以领取现金红包，并且还有分红模式，快乐招财犬app通过不断地合成，获得更高级别的狗狗奖励会更加丰厚，还能通过他合成升级获得更高的奖励，邀请好友加入还有额外的收益，并且可以拿到团队奖励。
快狗广告	软件特色
快乐摇钱树	　　快乐摇钱树app是一款人气火爆、收益优渥的手机赚钱软件，
金枪鱼快讯	　　金枪鱼快讯app是一款每天都可以领现金红包的赚钱神器，不光如此，在金枪鱼快讯app上看新闻，分享文章给好友的同时，金枪鱼快讯app也有现金可以领取，内容都是优质健康的，让大家可以省去挑选文章的时间，同样的时间能够转发更多的链接，也就有机会获得更多点击量和收益啦，新人进入金枪鱼快讯app是可以开一个红包的哦。
培源期讯	培源期讯app是一款提供给理财期货的用户打造的资讯服务平台，这里会有大量的信息资讯提供给大家，让更多的用户都能来平台上阅读资讯，掌握期货的所有信息，全新的资讯都给用户汇集在这里，让用户在这可以掌握好自己的商机，看看有哪些期货是可以上车的，带用户来赚更多的收益，可以关注你需要的期货资讯哦。
乐闻快讯	　　乐闻快讯App是一款更新速度非常快的新闻资讯阅读软件。推荐给大家，在乐闻快讯App这里您可以进行新闻资讯阅读的赚钱，而且这些新闻资讯的种类类型是非常的多的哦，您可以挑选您自己喜欢的哪一类来进行阅读赚钱，此外，您还可以将文章进行转发哦，快来试试吧!
新朝文化	新朝文化app官方版能让大家去完成聊天任务快速赚钱的软件，这里会上线很多聊天任务让大家去选择，在空闲时间里完成即可，而且聊天的模式也是有很多选择，每天都能比较愉快开心的去网赚，带来的收益也绝对不会让大家失望。
新八海传媒	软件介绍
极简新闻	　　极简新闻软件是一款用朋友圈来做任务的推广类的app软件,极简新闻app不但协助店家推广商品，更让添加服务平台的小伙伴们轻轻松松感受发朋友圈推广挣钱，零门坎，零风险提成秒结，二十四小时内取现迅速到账，让您的朋友圈更有使用价值，一次参加永久性收益。
轻松猜成语	　　轻松猜成语app是一款超级有趣的手机软件，
AT聚头条	用户现在注册登录AT聚头条app就可以获得一定的奖励，同时还可以邀请自己的好友加入平台，邀请的好友越多你可以获得的收益也是越多的，还可以将AT聚头条app推广出去，也是有额外的奖励可以获取的，平台里面的奖励还是非常丰厚的，还可以完成平台上发布的一些任务来获取一定的收益。
成语接龙传	　　成语接龙传红包版是寓教于乐的成语闯关类手机游戏，在非常刺激的仙侠世界中，成语接龙传app能够体验到的乐趣是非常开心的，特色的剧情和玩法，通关各种提示来填写出正确的字体，组成全新的成语，同时还有一些字面解释，能够学习到它的典故，让你你挑战的同时还可以学习到各种类型的成语知识。
集集赞	　　集集赞app是一款非常有趣的点赞赚钱软件。集集赞主要是通过点赞来获取收益，用户注册就能获赠现金红包，每天通过点赞、关注等就能获得奖励，集集赞app的操作还是很方便的，随时都可以在线管理自己的任务完成状况，邀请好友也能获得永久分红，集集赞app提现门槛和手续费也很低，当天就可以到账了，轻松提高用户的赚钱效率。
闲米	　　1、闲米app作为一个做任务赚佣金的手机软件，安全靠谱，用户可以放心使用。
闪电糖果盒	　　闪电糖果盒app是一款完善的赚钱软件。用户可以通过这款闪电糖果盒app轻松的获得诸多的收益，平台为用户提供了大量的赚钱任务，重要的是这款软件里面的赚钱任务类型非常的丰富，用户还可以通过收徒弟、做任务、转发等来进行赚钱，不仅如此这款软件的提现到账速度也比较快，感谢的小伙伴赶快来一起赚钱吧！
鸡社区	鸡社区APP是一个在平台上虚拟养鸡就可以获得收益的平台，用户在平台上面注册登录之后，系统会给大家赠送一只云南鸡蛋，每天都可以产蛋，可以直接使用这些鸡蛋兑换收益，操作也非常的简单方便。在平台上面还有其他种类的鸡，需要大家使用平台兑换的收益来购买，不同种类的基因能够产生不同数量的蛋，你可以根据自己的实际情况选择。可以真正的实现0投资，只需要每天在手机上操作一下就可以了。
斑马能量	斑马能量正在空投，注册(收录至少14日内保持循环处理)并通过实名认证，获得能量卡一张，邀请补，团补，星级达人制度，团队化推广!
趣生活	　　趣生活app是一个聚合型区块链赚钱平台。趣生活app不仅是一个生活广告信息聚合、游戏信息聚合、社交电商聚合以及分享平台，而且还是一个发掘社交网络潜力、巩固社交网络关、系受益社交网络价值的分布式激励平台。具有零撸起步，不伤人脉，三层关系，合法合规，广告流量，资金正向，游戏电商，广阔市场等众多特点，是个人财富的共创平台。
丰乐惠牧场	　　丰乐惠牧场是一款赚钱项目，结合农场游戏理财模式，用户只需每天都会产币，可以领取任务获得更多奖励。
优活运动	　　优活运动app最新版是一款全新上线的运动赚钱软件，有了优活运动app这款软件，大家就可以将自己的运动量转化成相对应的收益，轻松赚钱啦！只要每天运动几千步，优活运动安卓版就会根据你的运动量自动发放相对应的运动金币啦！领取到的金币既可以在平台特设的商城板块内进行购物消费，也可以直接到账，一切皆由你自己来决定哟，想要一边运动一边赚钱的话，不妨来优活运动大胆一试！
迅运动	　　迅运动app是一款简单运动就可以挣钱的应用!多人挑战，晨起打卡，迎接新上架的一天，有氧燃脂，带你减肥，燃烧你的卡路里，运动小白，健身达人。迅运动app是爱走爱动爱跑步一族必备！
多人运动	　　多人运动游戏是一款很好玩的运动模拟游戏。多人运动赚钱玩家将会在这个最具有特色的竞技场开始一次最刺激的运动竞技，在多人运动游戏中，多人运动app玩家需要和非常多的对手开始竞争，有很多的不同运动比赛等着玩家，只有完成了比赛，玩家才有可能获取冠军。同时玩家还需要注意在比赛的过程中一定不要犯规，如果犯规了就会失去一些比赛资格。
365天打卡	　　365天打卡app是一个每天打卡领健康币，次日获得分红收益的平台，最近打卡赚钱项目层出不穷，而365天打卡app可以说是同类中收益最高的了，每次打卡可以领取8币，一共可以打十次，而且下级收益提成是百分百的，一天就是80个币，而10个币=0.1元，对比之前的习惯早起收益翻了好几倍了。
疯狂打卡	　　疯狂打卡app一款打卡赚钱的平台软件，里面每天在这里进行打卡签到就能获得收益，还会不定时的进行一些小任务的发布
我养马贼6	　　我养马贼6 app是一款备受手赚党称赞区块链养殖赚钱应用软件，
我要打卡ing	　　我要打卡ing APP是一款近期上线的手机打卡赚钱的软件，在我要打卡ing内主要就是可以在手机上关注到各种各样的打卡任务，我要打卡ing软件是可以直接在手机上关注到自己所喜欢的打卡任务，我要打卡ing帮助自己能够在手机上通过简单的方式为自己获得收益，我要打卡ing软件的方式比较简单，操作很简单，看几个视频做几个任务就可以了，有兴趣的可以自己下载试试。
etb挖矿	　　etb挖矿是享祥币模式，
德胜跑分	　　德胜跑分app是一个最新的跑分赚钱的平台。德胜跑分平台随时随地都可以进行跑分赚佣金的全新收益体验，一键开启更多样化的赚佣金福利内容，每天跑分随时开启，抢单接单轻松完成赚钱的全面乐趣，多姿多彩的生活就从此刻正式开始！
跑付运动	　　跑付运动app是一款只需要每天走路运动就能赚钱的手赚平台。这款跑付运动app中你可以将自己每天走路获得的步数通过兑换的方式来赚取收益。跑付运动app中不仅可以运动赚钱，跑付运动app每天还会推出各种抽奖的活动，你的所有收益都是可以快速提取到账的，快来跑付运动开始你的赚钱之旅吧!
优客挖矿	　　优客挖矿app是一款非常不错的手赚软件，
运步换购	　　运步换购app是一款运动走路赚钱的平台。注册运步换购app之后就可以开始赚钱，他每天会自动记录你的步数，可以用步数兑换商品，或者是提现都可以，无需投入，还能看到自己每天运动的数据，功能特别丰富，每天走走路就可以赚钱，在运动的同时还有钱拿，一举两得，收益也稳定。
漫步太空	漫步太空赚钱app，为用户提供完善的赚钱平台，用户可以在漫步太空app里通过合成星球来获取收益，每天只需要花很少的时间在线完成任务也有奖励，软件教程还是很详细的，让你轻松学习参与合成赚钱，保证都是真实有效的。
每天跑步	　　每天跑步app是一款全新上线的跑步赚钱软件，一边享受运动的快感，一边体验赚钱的乐趣，每天跑步就可以赚钱，跑得越多赚的越多，无门槛提现，实时到账。还有运动比赛参与，这里有很多运动小伙伴一起讨论交流。
友零花	　　友零花app是一款帮助用户们快速在手机上任务赚钱打造的稳定平台。友零花软件内汇集了各个工作领域的用户们，每个下载友零花APP的小伙伴是需要实名认证注册登录的，进入友零花平台之后可以免费领取到属于自己的新人红包，福利多多，友零花app每天还有不定时的红包可以上线领取，通过我们简单的操作就能获得收益，感兴趣的用户们可以来点击下载哦！
欢乐农庄	　　欢乐农庄app是最新上线的一款农庄生态养殖赚钱项目
DBB	　　DBB交易所app是只需轻松打理就可以获得收益的区块链赚钱APP，
每日快兼职	　　这里涵盖的工作岗位十分全面，各种类型都可以找到，每日还有最新的兼职在不断更新，用户们可以快速选到满意的兼职，同时每一个岗位的信息也都非常全面，点击进入即可快速查案和了解，还提供了更多优质的功能等着大家来体验，赶紧来试试吧。
神奇便利店	　　神奇便利店app是一款全新上线的手机赚钱软件，
支付宝国际版	　　支付宝国际版apk是一款向前来中国内地的外国游客开放使用的应用。
开元兼职	功能介绍
dcep数字货币	　　DCEP交易所app是一款非常热门的区块链赚钱软件，用户可以通过这款dcep数字货币软件在线进行交易，并赚取收益，软件操作简单，新手还有详细的解说，让用户可以快速上手，了解币圈内的最新资讯，掌握一手动态，这款软件交易非常安全靠谱，用户可以放心使用。
TSL天使链	　　TSL天使链app是一款众利模式的区块链软件，
前锦	　　1、手机上做兼职的任务，马上领马上做佣金马上到账
天辰国际兼职平台	　　天辰国际app这是一个非常不错的赚钱软件，兼职机会比较多，大家都可以在线找到适合自己的一些兼职任务，这里大量的手机网赚也是很适合大家，每天都可以结算一次，结算的资金都可以转入自己的账户，很多新的一些兼职签到都可以给更多的人，不要错过一些需要大家完成的新项目哦！
十八罗汉	　　十八罗汉，是款十分新奇有趣的挖矿网赚app，用户在十八罗汉注册就可以获得一位罗汉，你需要每天签到，尊奉罗汉产生收益，十八罗汉app上总共有9种类型的罗汉，每种罗汉会有不同的金币收益产生，你可以邀请好友来十八罗汉与你一起赚钱，也可以有更多的赚钱游戏选择。
橘子兼职	软件特色
传奇大富豪	　　传奇大富豪app是一款区块链游戏挖矿赚钱软件，
快鸡互助	　　快鸡互助系统是基于游戏生态而生，平台设置了多种鸡宝宝，每只鸡宝宝的价值、预约领养时间、收益天数、领养收益等各不相同。
跑分	　　跑分app主打计步赚钱，跑分软件通过一定奖励来鼓励小伙伴们加入锻炼队伍，每天只要完成跑分任务就有钱拿，更有新手注册礼包任你领取，并且跑分app还支持分分钟拿钱到账哦~不断推广用户加入，还能领取更多货币，可以说是目前比较给力的项目，千万不能错过哦
萌宠链	　　萌宠链app是一款在线领取宠物，培养宠物，当宠物达到一定水平后即可出银币还可以兑换金币，玩法有点类似双龙仿盘和米盈等平台;
人鱼乐园	　　人鱼乐园app是一款当下比较火爆的手机赚钱软件，新用户实名认证后就可以领取美丽的人鱼了，
亚太矿工链	　　亚太矿工链(Asia-Pacific Miner Chain)APMC是一个集区块链挖矿+社交+交易平台。涵盖产矿、挖矿、金融交易、线上商城等多个层面的商业模型，有机地结合了共享经济、区块链新型经济等模式，让数字资产交易不再停留于概念，可行地创造新价值空间领域。
趣味金猪	　　趣味金猪是一款区块链赚钱平台，用户在趣味金猪软件中通过养猪来赚钱。软件会给新用户一只小猪，用户要将小猪养大，然后卖掉就能赚到钱了。你能赚到多少钱取决于你养多少猪，非常的有趣味，不会像其他赚钱软件一样枯燥乏味，繁琐复杂。
好玩运动	　　好玩运动app是一款很给力的手赚软件，好玩运动app拥有庞大的社区互动人群，用户可以通过好玩运动app平台结交到喜好运动的知己，他们来自各个行业，线上线下都可以相约跑步，App会自动记录运动步数，兑换金币，最后将金币转化为现金奖励，省时省事，还能赚钱。
兼职乐发圈	　　兼职乐发圈靠谱吗？兼职乐发圈是一款0投入的没有风险的手机赚钱平台，这里主打发圈赚钱的模式，我们只需要将平台上所需要推广的内容分享到社交账号上就可以轻松赚钱了，赚钱方式非常轻松，没有操作上的难度，收益还是蛮可观的，到账速度也很快。
角塔链	　　TUR角塔链是一款全新的刚上线的手机挖矿赚钱app，这里拥有丰厚的矿池，通过软件可以进行货币查询以及各种买卖服务。还有区块链相关的资讯，每天实时更新，给你第一时间了解最新的行情。这里汇集了专业的团队，给你提供最专业的区块链相关的知识。你还可以邀请好友一起参与，邀请的越多，绑定的分红收益就越多。
韭王府	　　韭王府app是一款有关币圈赚钱的手机网赚应用软件，
蜂池hcps	　　蜂池hcPS软件采用顶尖的技术打造而成，蜂池app拥有最安全可靠的环境，用户在这里蜂池hcps赚钱不会有任何的问题。全新的挖矿赚钱平台，不一样的模式与方法，给用户带来不一样的乐趣，让你放心挖矿，安全有保障，邀请好友一起来赚钱。
闲暇生活兼职	　　1、各种任务查看，都是一些比较简单的兼职，可以轻松快速领取，手机上便捷赚零花钱轻松方便了不少；
趣乐兼职	趣乐兼职给各位想要赚点零花钱，找兼职岗位的各位带来便利，在这里有很多的就业机会，工作的类型也很多，比如奶茶店、超市促销员、配送员以及家教和健身房教练等，轻松满足各位求职者的需求，找工作更安全，而且所有的公司以及招聘信息都是经过严格审核，安全且好用。
星浩区块生肖猪	　　星浩区块生肖猪app是一款全新的区块链网赚平台，星浩区块猪玩法简单丰富，新用户注册即可领取红包奖励哦，用户需要饲养这头猪等他长大就可以用来兑换更多的小猪，养猪时间越长获取的收益越高，邀请好友可以赚双倍哦，全新网赚玩法等你来体验！
云钻矿机	　　云钻矿机app是一款手机ip挖矿赚钱软件，只需下载云钻矿机app，利用手机ip作为节点，实现手机闲置算力挖矿、云端挖矿、好友推广挖矿等功能，
誉傲兼职	誉傲兼职app这款赚钱平台的任务特别多，有很多任务都是可以在手机上完成的，不会占用大家过多的时间，利用空余时间就可以获得不错的收益，多种赚钱方式等你来体验，有时间就来这里体验吧。
总裁成长史红包版	　　总裁成长史红包版是一款好玩的总裁养成类角色扮演手游，总裁成长史红包版玩家在游戏中白手起家开启自己的商业人生，玩家需要自由经营自己的公司哦，管理好公司不断的赚取财富，提升自己的公司规模让游戏更加的享受哦！
大眼兼职	　　大眼兼职平台app是一款全新的手机兼职赚钱的软件，这个软件里面拥有大量兼职赚钱的工作，用户可以随意的选择，每天还在不断的更新着，都可以帮助用户快速的获得大量丰富的奖励。
掌阅兼职	　　找兼职，找实习，找工作，实力企业随你挑选，理想职位快速入职，严格审核企业信息，筛选每个兼职招聘岗位，确保每个岗位真实可靠，保证每个兼职安全放心
优享兼职	软件特色
锦鲤送金红包版	　　《锦鲤送金红包版》是一款休闲趣味的养殖游戏，玩家通过在游戏中饲养各种不同等级的锦鲤，出售获取金钱和红包！
上海银行企业手机银行	功能介绍
且慢	　　【组合创建】
梦幻水果红包版	　　这里每天都有许许多多的任务等你来完成，同时你赚钱就主要靠这些任务。
黄金大师	软件特色
大发发	　　大发发app是一款全新的转发文章赚钱软件。在大发发app上面有十分的丰富高质量的文章内容，通过大发发APP把看喜欢的文章随手转发分享到朋友圈上，获得朋友的点击打开阅读，那么就可以获得1元钱的现金奖励，大发发app的奖励超高，涨分速度快而稳，收益永久满10元提现，感兴趣的朋友赶快来下载大发发这款软件试试吧！
银联荟生活	　　银联荟生活app是一款非常便捷的便民生活缴费服务手机软件，包括手机充值、流量充值、固话宽带充值、加油卡充值、购买飞机票、火车票等，是您生活中的好帮手。
众牧宝	　　众牧宝是众牧科技(北京)有限公司推出的一款互联网养羊理财产品，是一家致力于改善农牧产业链结构的垂直类互联网+品牌，成功打通用户理财需求和农牧业农场主扩大养殖规模以及消除屠宰场账期平稳过渡的资金压力需求，网站上线的120天育肥羊和21天屠宰羊两个产品自上线以来受到广大消费者的热烈欢迎!
猴姆科技	　　线上有长期的，也有短期的任务，大家可以根据自己的时间来完成任务即可
中欧钱滚滚	　　钱滚滚是中欧基金旗下理财交易APP。
蜜蜂银行	
微利赐赏	　　微利赐赏app是一款全新上线的兼职做任务平台，微利赐赏app里有很多赚钱任务分享给大家，微利赐赏app用户们只需花上短短的时间就可以完成，这里的收益奖励也是很高，在线的任务都是经过了严格的筛选，大家可以开心赚零花钱，任务都是很简单。
云景打字	　　云景打字登录平台手机版上每天为用户带来海量打字任务，云景打字手机版用户可以根据自己的打字水平来接取适合自己的任务，想要赚钱的用户快来体验吧。
应用部落	　　应用部落app是一款试玩赚钱的手机软件，应用部落app拥有丰富的试玩任务，应用部落app支持各种游戏、软件试玩，新手送1元，任务价格0.8元起，每天都有任务更新，利用空闲时间轻松赚钱。
优步行	　　优步行app一款完美的走路赚钱平台，优步行app里用户可以享受边走路边赚钱的快乐体验，优步行app里的操作和玩法都非常方便简单，几个步骤就可以成功获得不错的收益奖励，海量福利等你来拿，感兴趣快来试试吧！
威客网兼职平台	　　玩应用APP也能赚钱啦。任何时候都可以打开威客网兼职平台app边玩边赚钱，我们将推荐最优秀的软件、游戏给您试玩，玩的开心赚的开心。
乐推传媒	　　乐推传媒app每天都会发布非常多的手赚任务，想要赚钱的朋友可以完成简单的任务来获得佣金，在乐推传媒app中你还可以邀请好友一起加入赚钱，可以获得更高的收益哦，喜欢的话就来下载试试吧!
春牧牧业	　　春牧牧业app是一款移动农场，用户发布养殖种植需求，百万贫困农户为您提供代种服务，AI智能养殖实时监控，确保每一份产品天然健康。从农户的菜园子到您的菜篮子，一起来体验云端农场的乐趣。
上融生活	　　上融生活app是一个地推网推都喜欢的APP，注册单，实名单，各种任务单，价格可市场对比，上融生活app提现金额2元24小时可到（目前恢复当日到帐），安全可靠，单子数量多，每天可做。(任务单价可比，站内佣金最高)
地推网推平台	　　地推网推平台是一款非常实用的手机赚钱软件，地推网app功能十分强大，地推网app里面有非常多的赚钱任务，用户随时可以领取任务赚钱，操作简单，并且没有时间规定，想做就做，轻松赚取零花钱。
抖音情报站	　　抖音情报站app是一款基于抖音推出的网赚软件，抖音情报站app里每天都会上线与抖音相关的任务，抖音情报站app任务类型比较丰富，基本上你都能做，通过手机简单的几步就能够完成，可以每天观看视频或者点赞评论，也能够将视频分享到不同的平台上让更多的人看到，只要有人点击就会产生收益。
抖音赚客	　　抖音赚客app是一款点赞悬赏赚钱软件，抖音赚客赚钱上有丰富的任务内容，抖音赚客app用户可以每天随时随地刷视频，随手点赞、关注、互动就能轻松获得收益，没有时间限制，操作简单，安全靠谱。
快译猫兼职	　　快译猫兼职结合数十亿句对精准级大语料数据（TM库）和专业术语库、智能CAT、智能任务分派系统、智能纠错与自动排版系统，为顾客提供高品质、高时效、高性价比的专业翻译服务、“一带一路”外语人才外派服务、专利翻译服务、本地化服务、职业翻译培训服务、大语料数据库服务、会展、体育赛事等语言服务整体解决方案, 以及基于多语言服务优势的延伸服务，如多语字幕、多语宣传片、影视剧译制、多媒体制作等。
杏耀平台	　　杏耀平台app是一款非常好用又灵活的手机赚钱平台，杏耀平台app里为大家提供的手机赚钱任务是非常的多，而且杏耀平台app操作方式是非常的简单，所有的用户都能在这里自由的接单，时间地点都是特别的自由哦！
抖音宝	　　抖音宝app是一款通过点赞就可以获得收益的手机平台，每天都可以领取很多任务以及福利，平台还有派发很多的红包大礼，更新也非常快，用户可以自主的进行管理。
趣步433	　　趣步433新版本是互联网运动健康倡导品牌，由湖南趣步网络科技有限公司专业技术团队倾力打造开发的运动APPDD趣步433，一款让您在运动中结交新朋友，收获快乐的APP。健康运动，快乐趣步，用此APP，让汗水不白流。
平安金管家	最新动态
汇赚助手	　　汇赚助手卡密里面有很多的赚零花钱渠道，里面主要就是理财赚零花钱，里面赚零花钱方式透明公开，也是非常的安全靠谱的。在里面邀请好友赚收益也是非常的快速的，喜欢网赚的朋友快来下载汇赚助手app一起赚吧！
七彩赚钱	　　七彩赚钱app是一款手机任务软件，用户可以通过七彩赚钱软件看到非常多的任务信息的，七彩赚钱app只需要你自己选择合适的进行完成就可以了，这里的任务收益也是比较高的。
七彩网	　　七彩网app拥有超多网赚任务，七彩网app可让所有人都有得到收入的机会，七彩网app任务内容全都比较简单，但悬赏非常高，可以轻松通过这里赚零花钱，每日的收益用来养活自己是完全没问题的，而且还能分享给朋友，约伴一起翻倍赚。
充电快乐赚	　　充电快乐赚app是一款十分非常好的手机挣钱软件，充电快乐赚app只需给手机充电就能获得盈利，充电快乐赚app不但给客户出示了暖心的充电服务项目和电池管理作用，还能在充电的另外全自动获得金币哦。
看视界	　　看视界app通过观看短视频在线积累收益，在看视界app平台内不仅可以随时的观看短视频获取很多的乐趣还可以赚取不菲的收益，很多用户在看视界app里可以对短视频进行点赞以及评论关注，还可以自己发布短视频哦，保存以及分享到自己的社交平台都是可以的。
优赚挂机	　　优赚挂机赚钱软件一款可以在手机上挂机赚钱打造的平台，在APP内包含的挂机任务超级丰富，是可以直接通过挂机为我们带来更多的收益，APP内的挂机赚钱方式简单便捷，没有什么限制，时间地点随你选，收益也可以随时提现，带来更多的趣味方式。
GOC	　　GOC app是一个新上线的挖矿分红软件。新人注册goc交易所app就可以参与空投的活动，得到一个矿机，直接一定的周期就能领取奖励，GOC区块链是一个不用投资，能随时0撸，交易数字货币的平台。大家可以熟悉goc挖矿平台的制度，参与拉新的推广制度！
公益联盟	　　公益联盟app是一个新上线的挖矿分红软件。公益联盟app每天都有新的矿机免费为大家提供，随时都可以参与进来，公益联盟app有不同的任务可以自由选择，不论是签到、阅读浏览还是其他的任务，只要完成之后，就可以获得相关的收益了，记录十分全面，公益联盟app还有一些最新的区块链信息为大家提供，相信大家在这里可以掌握更多内容。
银联收银台	　　随心刷，刷卡享优惠
微淘抢单	微淘抢单为用户提供安全可靠的赚钱平台，用户每天只需要花很少的时间在线抢单就可以获得奖励，随时都可以在线赚钱，收益还是蛮不错的，随时都可以进行提现，手续费非常低，让你轻松体验生活的乐趣。
巅峰抢单	　　巅峰抢单app是一款网赚软件，可以随时随地玩转网赚任务，大量的赚钱任务及时通知，你可以根据自己喜欢的挑选自己感兴趣的网赚类型，完成就有高额返佣领取，保证每人都有单做，让你每天不缺零花钱。在线推广邀请亲朋好友一起参与还可以获得高额返佣。适合众多的拥有丰富的空余时间的人群。打发时间还可以赚钱。
趣购抢单	趣购抢单app是一款全新上线的手机赚钱软件，软件功能非常强大，里面有非常多的赚钱任务，用户随时可以抢单做任务，操作简单，时间自由，在家就能轻松赚钱。
优众抢单神器	　　优众抢单神器app里汇聚各大知名的电商平台的单子，你只要在线接单就可以做任务在群里，优众抢单神器app里就是在平台下单购物，优众抢单神器app里是需要你先进行垫付的，就是给商家增加销售量以及营业额还有流量的，按照平台的要求步骤完成以后就会连本带佣金的发放给你。
淘购抢单	　　淘购抢单app是一款在线领取任务赚钱的平台，平台上每天都会更新很多的任务，并且都比较的简单，用户利用一些碎片化的时间就可以轻松完成，就会获得收益，邀请好友还有额外奖励，平台上每天也有很多福利活动，赚钱超级轻松。
酷U抢单	如果你对做任务的赚钱软件情有独钟的话，酷U抢单app一定能满足你的需求，这里有超多类型的任务可以挑选，更新都是很及时的，还有更多活动和玩法可以体验，轻松提高用户的赚钱体验。
众鑫抢单	　　众鑫抢单是一款在线接单工具，这里有很多的任务等你来完成，注册之后就可以开始接单，没有任何门槛，可以让你在更短的时间内获取到收益，有多种类型的任务等你来领取，完成任务就能获得高额的收益，适合各类玩家，只要你有时间就可以来这里赚钱，提现无需手续费。
玖富抢单	玖富抢单每天都会发布很多新的订单，用户在抢单成功之后需要在两分钟之内提交订单，不然的话接下来的24小时都不可以操作。在平台上面的任务非常的多，有很多的商家有需要推广的，所以会在平台上面发布推广订单任务，大家在抢单之后就要快速的完成。
金手指抢单	　　金手指抢单为用户提供安全可靠的抢单平台，这里每天都会更新大量的任务，种类还是很丰富的，你可以选择自己喜欢的去完成，操作非常方便，还能在线管理自己的收入明细，从多方面让你轻松赚到零花钱。
天霸抢单	　　天霸抢单app，一个随时接任务、抢单、玩手机试玩、参与手机赚钱的活动、推广广告的赚钱综合平台，是一个可以轻松学习到各种模式的赚钱方法。
极客抢单	　　极客抢单app有着大量丰富的任务资源，全部都是实时更新的，按照每一个用户的要求进行，对于使用来说是很便捷的，为您提供了海量的服务，想要的都能找到，随时都能了解到最新的信息，让您可以很轻松的赚钱。
洋码头抢单	　　洋码头抢单赚佣金是一款专门针对于洋码头软件推出的一款线上抢单赚钱软件哦，洋码头抢单app很多简单的抢单任务都会在这里为你快速的推荐到的，让你能够很直接快速的在这里做任务抢单获取收益，洋码头抢单app能够很好的帮助到大家在线进行抢单赚钱。
518接单	　　新人秒送7毛红包
宇派接单	宇派接单app平台使用也没有门槛的限制，也不需要用户任何的投资，就直接下载注册登录就可以开始赚钱了，并且新用户登录宇派接单app还可以获得现金红包奖励，使用的时间也是非常的自由，想什么时候接单就什么时候接单，还可以实时的查看自己的收益详情哦，轻轻松松就能赚到不少的零花钱。
雷蛇接单	雷蛇接单app里有大量的接单任务可以完成，用户们每完成一个接单任务就会获得相应的佣金奖励，完成的任务越多你可以获得的收益也就越多，用户一天下来的收益还是很不错的哦。
淘宝接单	　　淘宝接单平台软件是一款非常不错的接单平台，在淘宝接单大厅app里大家每天都能接收大量的任务信息，可以根据自己的喜好来领取哦！而且淘宝接单app还支持多个账户同时进行，淘宝接单app让大家能赚到更多收益哦！有需要的快来下载吧！
零活接单	零活接单app每天都会实时的更新海量的任务，这里不同的任务的佣金也是不一样的，也有许多高额佣金的任务，你可以随意在线进行挑选自己喜欢的任务，你完成接单任务之后就会立即获得相应的佣金奖励，用户利用自己空闲的时间完成平台上的任务就可以了，轻轻松松就能赚到不少的零花钱。
创一接单	创一接单app是一款给用户带来优质的接单平台，创一接单app里每天都会更新大量的任务，佣金都是蛮不错的，用户绑定账号就可以参与赚钱，满足平台的要求就可以了，每天花一点时间就能赚到零花钱，让你轻松体验在家赚钱的乐趣。
桔子接单	　　桔子接单app是一款超级好用的手机赚钱软件，桔子接单app很多实用的功能玩法等你来新趣网下载实用，桔子接单app很多有意思的玩法你可以有更多的选择自己喜欢的任务哦，每个任务的设计玩法都不同。
乐享接单	　　乐享接单app为用户提供了大量的任务，任务类型你可以自己选择，乐享接单app里有一个专门的任务排行榜，你完成的任务比较多就能登上排名，每天都有一次总结算能够让你获得额外的奖励，只需要一部手机你在家就能做任务，十分轻松。
爱米接单	　　爱米接单app是一款非常简单的手机赚钱软件，爱米接码app主要是通过刷单来获取收益，用户需要绑定自己的淘宝账号才可以在线接单，随时都可以在线赚钱，用户根据任务介绍完成就可以领取佣金，审核速度还是很快的，而且提现不需要手续费，不用担心赚不到钱，喜欢的朋友不要错过哦。
企鹅接单	　　企鹅接单软件是一款非常火爆的在线接单赚钱软件，你可以使用企鹅接单app更好的进行各种在线接单赚钱，同时软件具有海量任务，各种类型一应俱全，你可以更好的进行选择，并且软件操作接单便捷，还可以随时随地进行提现，海量现金红包等你来领，喜欢的小伙伴赶紧下载吧。
小火箭接单	小火箭接单app是能通过这个平台去灵活接单赚钱的软件，高收益的兼职资源都能在这里上线，而且做兼职的方式也是非常趣味的，每天都能选择不一样的兼职去完成，手机上灵活快速的接单能给大家提供很多方便，做兼职任务让你收益满满！
微信辅助接单	　　微信辅助接单平台app是给大家赚零花钱机会的工具。微信辅助接单app这个全新接单赚钱平台会给大家带来海量的兼职资源，利用自己的闲暇时间去完成兼职会有一些收益可以获得，同时自己也是不需要垫付的，能特别安心无忧的在这里网赚，一般随时都能去提现的！
大树王接单平台	　　大树王接单app是一款手机上的接淘宝刷单任务的平台，这个平台从18年就开始做了，现在也是比较的稳定，不看号不认号，审核比较简单，很多的商家都在这里放单，然后你在这里可以接单，按照商家的要求拍单即可，获取一定的佣金。
微赚发圈	　　微赚发圈是一款非常火爆的赚钱软件，你可以使用简易赚app更好的进行各种任务赚钱，同时软件具有海量任务，各种类型一应俱全，你可以更好的进行挑选，并且软件操作简单便捷，还可以随时随地进行提现，海量现金红包等你来领，还可以更好的进行各种推广赚钱等等，各种礼包登录健康领取，操作简单便捷。
天矿之信	　　天矿之信交易系统是依托天津矿产资源交易所开发的一款在手机平台上使用的金融终端。主要采用列表和图形的方式展现天矿油、再生铜、金精矿、银精矿等天矿所交易品种的行情及走势。投资者可以方便快捷的交易，并且通过持仓明细、持仓汇总、挂单、平仓单、资金账户等可以详细了解交易情况，轻松实现行情、操作和账户管理的三位一体。
三和赚米宝	　　三和赚米宝app是一款非常不错的手机接单软件，用户在三和赚米宝app里可以自由选择想要接单的任务，没有任何限制。不用担心自己没有经验，任务大多非常简单，能让你轻轻松松就赚到钱。感兴趣的小伙伴快去下载吧!
舒畅赚	　　舒畅赚app是一款非常热门的手机网赚软件。舒畅赚软件里面有很多丰富的网赚资源，有阅读文章的，转发内容的，试玩游戏的，这些都非常的丰富，都可以让用户在手机上轻松的来赚钱，收益也是非常的丰厚，随便看看新闻资讯，随便玩玩游戏，一键来转发，轻松就能赚钱，喜欢在手机上轻松赚钱的，用户可以直接下载软件来操作吧。
智能赚	　　智能赚app是一款非常好用的手机在线任务赚钱软件，智能赚钱app软件能为用户提供非常简单的赚钱方式，用户在线进行挂机阅读就能轻松获取丰厚的收益，用户无需任何风险投资，在线动动手指就能轻松赚钱，每天都可以随时进行提现，方便用户进行使用。有需要的朋友欢迎下载智能赚钱app软件！
智能赚佣机器人	　　智能赚佣机器人app是一款非常好用的手机在线任务赚钱软件，智能赚佣机器人平台能为用户提供非常简单的赚钱方式，智能赚佣机器人app用户在线进行挂机阅读就能轻松获取丰厚的收益，用户无需任何风险投资，在线动动手指就能轻松赚钱，每天都可以随时进行提现，方便用户进行使用。
开心养羊	　　开心养羊app是一款新型赚钱平台，用户可以在该平台上购买山羊，在一定的养殖周期内，投资者用户可以收回投入的成本并获得收益，在整个过程都是公开透明的，保障其利益！
痛快赚兼职	　　痛快赚app是一款兼职工作软件，你可以在痛快赚兼职app中选择自己适合的兼职来进行获取丰厚的奖励，痛快赚app每天都会更新不同的兼职工作，让你来体验。软件中的任务量非常的多，不用担心，没有任务可以做，每一条任务都可以获取相应的奖励，对这款兼职软件，感兴趣的小伙伴快来下载吧。
小鱼优选赚钱	　　小鱼优选app归属于杭州乐鱼惠科技有限公司，致力于为广大朋友提供解决问题的平台。一款悬赏互助兼职赚钱平台，海量悬赏任务，新用户加入即可做任务赚钱。有需求，来小鱼优选，众人帮你！目前小鱼优选合伙人计划火热进行中，全网招募合伙人，享全平台30%利润分红，赶快来试试吧！
幸福养鸡场	幸福养鸡场红包版是一款通过经营养鸡场来领取各种福利和红包等奖励的模拟养成游戏，不知道为什么今年这些养动物的模拟游戏都特别的火爆，尤其是开农场养各种小动物的，玩法休闲简单不说，而且是不是还能够领取一波福利，也算是非常靠谱的了，那么赶快来下载这款幸福养鸡场开启你的幸福养成之旅吧！
天天养猫猫	　　天天养猫猫游戏是一个手机养猫赚钱的游戏软件，天天养猫猫游戏可以帮助广大用户在线养猫赚钱，天天养猫猫游戏不仅仅是养猫还有其他的一些推广任务，完成起来简单，轻松赚钱。
青鸟转发	青鸟转发app，这是款主要进行转发获取收益的软件，只要用户们在这里进行了转发就能够赚取到一定的收益哦，而且这些收益还非常的稳哦，这样用户们就不用在担心没有零花钱可以使用了哦，同时在这里将软件进行推广也是能够获取到额外的收益哦，还在等什么，快来试试吧！
草莓看点	　　草莓看点app是一款能够赚钱的资讯平台。只需要将你在草莓看点app当中所看到的各种好玩的好看的内容转发到你的朋友圈当中就能够极为快速的进行赚钱提现，草莓看点app的提现基本上没有金额的限制，你能够拉上各种好友来一起在这款软件上面进行转发赚钱，获得朋友的点击阅读那么就能够获得悟空转给我们的现金奖励，草莓看点的单价高，涨分快，转发红包多，不会乱封号，属于难得的好平台，转客必玩。
全民养宠物	　　全民养宠物赚钱app这是一款全民养宠物赚钱的游戏，在游戏中有着各种可爱的小宠物，每个宠物都有着不同的造型，玩家可以通过不断的合成来获得更加高级的宠物，不同的宠物可以获得不同的收益，越是高级的宠物能带给你的奖励是越多的，玩家在游戏中还能通过宠物带给你的金币来兑换各种服装，将你最高级的宠物打扮一下进行竞技选择，比一比谁的宠物更靓丽更可爱。
九九转	九九转app，是一款阅读发赚钱应用。用户可在该平台上选择标题吸引人的文章直接转发到朋友圈，吸引更多的人前来点赞。点赞数数量越多，收益也就越多。你也可以自己阅读来赚取额外的红包收益。
贼好赚	　　贼好赚APP是非常优质的一个线上任务平台。贼好赚主要是通过完成任务来获取收益，用户注册就能获赠现金红包，每天签到和完成平台任务的奖励还是蛮不错的，贼好赚app不需要任何投资，通过邀请好友也有额外的分红，在线参与试玩、阅读、转发的佣金还是蛮高的，随时都可以进行提现，更有多种活动和玩法可以体验，让你享受舒适的赚钱生活。
米来赚	　　1、平台这里可以帮助用户们快速获得各种收益，每天都可以来轻松抢单；
多玩多赚	　　多玩多赚是一款有趣好玩的游戏试玩平台
我养牛贼6	　　我养牛贼6游戏是一款卡通风格的牧场模拟经营的软件，我养牛贼6游戏的玩法是非常休闲的而且能够让玩家感受到趣味，在这里有着各种不同的牛让你去进行着喂养，而且首先你需要去建立一个牧场让这些牛可以在草原上自由的奔跑，而且有着你要去接受很多不同的订单，让自己能够将其全部的进行售卖赚取大量金币，在进行和牧场的扩建。
涨尚宝赚钱	　　平台上的接单都是免费提供的，通过帮助别人提供的任务来赚取佣金
趣养招财鼠	　　趣养招财鼠app是一款养鼠赚钱的手机软件，
养鸡大作战	　　养鸡大作战app是一款玩法体验妙趣横生的休闲放置类模拟经营手游，
果木赚	想要一边玩游戏一边赚钱吗，在这里小编就为大家介绍这款赚钱软件，果木赚，你可以使用软件进行各种农场，果树赚钱，软件拥有海量果树，各类品种一应俱全，登录即可领取免费树苗，新人红包等你来领，随时轻松提现，各种隐藏奖励等你来找，帮您轻松赚钱。
疯狂养鸭场	　　疯狂养鸭场是一款非常有意思的养鸭赚钱平台，用户可以一边在线享受养鸭的乐趣， 还能享受碎片时间赚零花钱的乐趣，疯狂养鸭场通过合成的方式来解锁更多鸭子的品种，还能将稀有的鸭子品种兑换成高额的现金红包奖励！
微手赚网	　　微手赚app是一款值得用户们长期拥有的手机网赚神器，微手赚app上有着超多不同类型的网赚任务，微手赚app涵盖了各种各样的赚钱模式，平台任务单价都是比较高的，完成起来简单，佣金到账迅速，感兴趣的可以来下载微手赚app。
试赚宝	　　试赚宝app非常不错的手机接单赚收益平台，在试赚宝app里面有非常多的单子可以接，还有各种各样的任务可以做。在试赚宝app里面做单子，做任务都是非常的简单的，很多的朋友都在里面赚到了很多佣金，喜欢网赚的朋友快来下载试赚宝app一起赚吧！
淘网赚	　　淘网赚app是一款靠谱的抢单赚钱软件。淘网赚app这里汇集了海量的抢单任务，数量不限，用户可以自由的在这里进行任务的领取，每天的任务都会进行更新，还能进行邀请好友分佣赚钱，每天打卡签到也是有红包奖励的，无需任何的投资，安全可靠，门槛低，完成任务就会获得相应的收益，提现速度快速，当天就能到账哦。
欢乐养狗狗	　　欢乐养狗狗红包版是一款玩游戏合成狗狗升级赚钱的软件，简单的游戏玩法，和其他的合成赚钱软件一样都是通过升级领取和获得平台的分红等方式来赚取现金奖励。在欢乐养狗狗领红包中，玩家需要领养狗狗，陪伴它成长玩耍就能够获取好感度，不断提升好感度就能够获取红包，快来下载欢乐养狗狗领红包吧！
开心养猫	　　开心养猫红包版是一款全新的0撸养猫赚钱软件。开心养猫app的玩法跟我们熟知的养狗、养猪合成一样，通过将两个品种一样、等级相同的猫咪进行合成来获取收益，不断升级猫咪还有机会获得分红猫，一元即可提现，秒到账，无手续费！
摩方赚兼职	　　1、平台能够以大众为本，为大家提供方便客户的兼职求职体验，在找兼职的过程中不需要你投入一分钱；
福气养猪场	　　福气养猪场红包版是一款十分精彩好玩的养猪赚钱游戏，游戏里玩家将会经营一家十分出色的养猪场，你将会来到这里不断地养殖一些小猪，注意相同的普通小猪可以恒成为品质较高的高级小猪，整体的玩法简单欢乐多多，玩家们就算采用挂机养成的方式，也可以收获大量的金币，更有精彩的红包等你来领取。喜欢这款软件就快来下载吧！
天天养羊场	　　天天养羊场红包版是一款经营小羊类的大型饲养场软件。这个广阔无边的草原当中，可是拥有了众多不同的小羊们存在当中，那些鲜美的草地，就是他们最喜欢的地方，你通过不断的饲养小羊仔们，来帮助自己收获众多的财富值，不仅仅可以提升自己的养殖场，同时还能让你的去购买众多更好的饲养，以及购买一些装修饰品，让你的养殖场变得更加的豪华。
大大养鸡场	　　大大养鸡场红包版是一款养鸡就可以赚钱的软件，下载注册就送小鸡，大大养鸡场红包版用户可以不断的来喂养小鸡成长，长大就可以下蛋来为用户带来可观的收益，用户每天签到就可以领取鸡饲料哦，快来使用!
萌惠赚	软件特色
宅客赚	　　宅客赚app是一款全新上线的手机赚钱软件，宅客赚app为用户提供超级多的赚钱任务，只要完成任务就能获得相应的奖励，每个任务的收益各不相同，做得越多赚得越多，非常适合有大把时间的用户，喜欢的话快来下载宅客赚试试吧!
闲淘赚	　　这个板块可以植入自己的广告到用户浏览网页，比如植入到微信里面，小说里面，其他有关平台里面！
趣闲赚购	　　趣闲赚购app官方手机版是一款用于购物分享的手机应用，通过购物分享获得购物的奖励，实现了当下非常火热的分享社交方式，更好地进行好玩分享。平台为大家带来了丰富的商品，每个商品都明码标价，大家可以选择合适的商品进行分享推广，他人成功购买即可。
速赚空间	速赚空间app是真的可以赚到零花钱，用户现在注册就能获赠现金红包，每天签到和完成任务就有奖励，包括试玩、阅读、分享等，操作还是很简单的，不需要任何投资，邀请好友也能获得永久分红，同时速赚空间app随时都可以进行提现，还有详细的任务教程可以学习，帮助用户更快捷的赚到零花钱
抖能赚	抖能赚app是一款在线上轻松赚收益的软件平台，在线上用户可以自由的选择任务，领取各种类型的任务资源，很多的兼职的任务都会在上更新，为用户带来更多的收益，这里面的收益也很多的，大家在首页就会看到，给用户更多选择，每个任务上都有收益的金额显示，用户在里面可以选择高收益的，也能选择低收益的。
易赚刷单	用户随时都可以在易赚刷单app在线进行刷单，易赚刷单app里面的刷单任务都是非常简单的，几分钟就可以完成一个刷单任务，每天登陆签到也是可以获得一定的收益，还可以邀请自己的好友加入平台，也是有一定的收益可以获取的，用户一天下来的收益还是很不错的，轻轻松松就能赚到不少的零花钱。
欧赚抢单	　　欧赚抢单app主要是为用户们带来更加全面的赚佣金方式，欧赚抢单app超多福利内容完美的体验其中，轻松赚大家期待的佣金好礼，涵盖领域更全面，试玩、转发、抢单等超多赚钱新体验！
南极乐园	　　南极乐园互助系统模式游戏介绍中只需用5个USDT养游戏账户，就可以加入我们的南极乐园了。
云赚视频	　　云赚视频app是一款观看短视频轻松赚钱的一款软件，这里有超多观看短视频轻松赚钱的任务等你来领取，你只需要一部手机就可以轻松解锁这些赚钱任务不需要外出每天在家就可以轻松赚钱，你还在等什么呢？
MOD松鼠	　　MOD松鼠app是一款全新的网赚平台，
星球矿工挖矿	　　星球矿工app，全新上线推出的一款挖矿赚钱平台，
圆梦牧场	　　圆梦牧场，是一款养殖赚钱类的软件，
鹤选赚	　　精选优质好工作，靠谱好工作认准鹤选赚，
爱宝中队	　　爱宝中队app试玩是一款最近流行的试玩赚钱软件。爱宝中队兼职app这里的兼职任务非常的多，用户可以轻松的进行理财赚钱。并且任务的领取也是非常的简单，不需要你抢任务，不管你是什么是后上线，都能够在第一时间内获得任务。客服24小时在线，只要你有问题，都能够第一时间咨询。
萌犬爱便便	　　萌犬爱便便赚钱版是一款非常火爆的手机赚钱类的软件，
硅谷区块鸡	　　硅谷区块鸡是一款可以通过养小鸡进行赚钱的app，用户在刚开始就能获得一只小鸡，你需要不断去照顾它，喂它吃饲料，在它成长的过程中，会不断产出AEC币，当然等级越高产出的币也就越多，所以大家一定要精心照顾。非常可靠的赚钱模式，支持大家积极参与其中，还能体验养殖的欢乐哦，非常好玩；全新的赚钱模式，与游戏的形式结合，给大家推送了更为便捷的赚钱平台，随时轻松赚钱。
玩赚时代	　　玩赚时代app是一款时下超多客户都会应用的app赚钱，进行相匹配的试玩游戏每日任务即可获得奖励，大量很多抖音每日任务等着你进行，点赞评价都能获得盈利，跳转初学者专享礼进行新手每日任务附加奖励28元，每日初次登录也有幸运转盘等着你摇哦
迅腾服务	　　迅腾服务app让你每走一步都是为健康投资，并且你的每一步都又收益，在获得健康的同时，还可以每天都完成任务去赚钱！从现在开始加入迅腾服务开启运动赚钱新模式，让每次的努力都有价值，遇到更好的自己！
猜歌名大师赢红包	　　猜歌名大师赢红包是一款手机上的唱歌平台。猜歌名大师既可以听歌又可以挑战乐感能力，听取一段音乐，由这段音乐来猜出歌名，并且要从给出歌曲名称选项中选出正确的歌名即可过关，注意哦，必须是要猜出当前关的歌名才能进入下一关哦！
点乐赚	　　点乐赚app是一款拥有多种方式赚钱的一款软件，试玩任务、悬赏任务、阅读任务这些任务我们一个软件就拥有、如果这些你都不喜欢你还可以去小说区轻松看小说赚钱，任务的单价保证你都会满意，只要你有时间我们就能让你很轻松的赚钱，你还在等什么呢？
分红鱼	　　分红鱼app，一款有趣的手机赚钱工具，操作简单，里面有非常多的赚钱项目，用户就利用闲暇时间养养鱼，等它们长大了可以将它们合成就可以赚钱收益了，非常好玩，等级越高赚的钱就越多。
养鹅大亨	　　养鹅大亨app是一款人气火爆的区块链养殖赚钱软件，
富金服务	　　富金服务app是很不错的一款阅读赚钱软件，给用户提供众多的优质文章阅读，每次操作起来也是非常的轻松，难度也是比较的小，但是获得的奖励还是很客观的，让你每天都可以赚到一点零花钱。
破零红包	　　破零红包app是一款手机在线赚钱类的软件，
猜字红包	　　猜字红包app是一款手机赚钱类的软件，可以帮助用户在家也能赚取红包，
种地分红	　　种地分红app是一款目前很火爆简单好玩的虚拟农场种植的软件，
养猫大亨	　　养猫大亨红包版，喵喵喵，这是款十分带感的挖矿网赚平台，
牛场达人	　　牛场达人app是款全新上线的手机区块链养殖赚钱平台，也是大家最喜欢的牧场系列的区块链游戏，在这里面就好像在玩qq牧场一样，就可以轻松赚钱！非常适合闲暇时光很多的宝妈以及学生党，甚至上班族都可以当副业！也是非常的棒！上线就送牛让你0投资赚钱！
摩登赚	　　摩登赚app是一款赚钱平台，
橙大庄园	　　橙大庄园app是一款集现代种植、娱赚钱乐集一体的现代庄园，
